CGGCGTGACTG: GGCGTGACTGG
GGCGTGACTGG: GCGTGACTGGG
GCGTGACTGGG: CGTGACTGGGG
CGTGACTGGGG: GTGACTGGGGT
GTGACTGGGGT: TGACTGGGGTG
TGACTGGGGTG: GACTGGGGTGT
GACTGGGGTGT: ACTGGGGTGTG
ACTGGGGTGTG: CTGGGGTGTGT
CTGGGGTGTGT: TGGGGTGTGTT
TGGGGTGTGTT: GGGGTGTGTTT
GGGGTGTGTTT: GGGTGTGTTTG
GGGTGTGTTTG: GGTGTGTTTGC
GGTGTGTTTGC: GTGTGTTTGCT
GTGTGTTTGCT: TGTGTTTGCTA
TGTGTTTGCTA: GTGTTTGCTAG
GTGTTTGCTAG: TGTTTGCTAGT
TGTTTGCTAGT: GTTTGCTAGTA
GTTTGCTAGTA: TTTGCTAGTAA
TTTGCTAGTAA: TTGCTAGTAAA
TTGCTAGTAAA: TGCTAGTAAAT
TGCTAGTAAAT: GCTAGTAAATA
GCTAGTAAATA: CTAGTAAATAC
CTAGTAAATAC: TAGTAAATACT
TAGTAAATACT: AGTAAATACTG
AGTAAATACTG: GTAAATACTGT
GTAAATACTGT: TAAATACTGTG
TAAATACTGTG: AAATACTGTGT
AAATACTGTGT: AATACTGTGTC
AATACTGTGTC: ATACTGTGTCG
ATACTGTGTCG: TACTGTGTCGG
TACTGTGTCGG: ACTGTGTCGGT
ACTGTGTCGGT: CTGTGTCGGTG
CTGTGTCGGTG: TGTGTCGGTGG
TGTGTCGGTGG: GTGTCGGTGGA
GTGTCGGTGGA: TGTCGGTGGAG
TGTCGGTGGAG: GTCGGTGGAGG
GTCGGTGGAGG: TCGGTGGAGGA
TCGGTGGAGGA: CGGTGGAGGAC
CGGTGGAGGAC: GGTGGAGGACA
GGTGGAGGACA: GTGGAGGACAG
GTGGAGGACAG: TGGAGGACAGA
TGGAGGACAGA: GGAGGACAGAC
GGAGGACAGAC: GAGGACAGACA
GAGGACAGACA: AGGACAGACAC
AGGACAGACAC: GGACAGACACA
GGACAGACACA: GACAGACACAC
GACAGACACAC: ACAGACACACC
ACAGACACACC: CAGACACACCA
CAGACACACCA: AGACACACCAC
AGACACACCAC: GACACACCACT
GACACACCACT: ACACACCACTA
ACACACCACTA: CACACCACTAA
CACACCACTAA: ACACCACTAAG
ACACCACTAAG: CACCACTAAGC
CACCACTAAGC: ACCACTAAGCT
ACCACTAAGCT: CCACTAAGCTC
CCACTAAGCTC: CACTAAGCTCC
CACTAAGCTCC: ACTAAGCTCCC
ACTAAGCTCCC: CTAAGCTCCCC
CTAAGCTCCCC: TAAGCTCCCCT
TAAGCTCCCCT: AAGCTCCCCTA
AAGCTCCCCTA: AGCTCCCCTAA
AGCTCCCCTAA: GCTCCCCTAAA
GCTCCCCTAAA: CTCCCCTAAAA
CTCCCCTAAAA: TCCCCTAAAAT
TCCCCTAAAAT: CCCCTAAAATA
CCCCTAAAATA: CCCTAAAATAC
CCCTAAAATAC: CCTAAAATACG
CCTAAAATACG: CTAAAATACGA
CTAAAATACGA: TAAAATACGAT
TAAAATACGAT: AAAATACGATT
AAAATACGATT: AAATACGATTA
AAATACGATTA: AATACGATTAG
AATACGATTAG: ATACGATTAGG
ATACGATTAGG: TACGATTAGGA
TACGATTAGGA: ACGATTAGGAA
ACGATTAGGAA: CGATTAGGAAA
CGATTAGGAAA: GATTAGGAAAA
GATTAGGAAAA: ATTAGGAAAAA
ATTAGGAAAAA: TTAGGAAAAAG
TTAGGAAAAAG: TAGGAAAAAGC
TAGGAAAAAGC: AGGAAAAAGCT
AGGAAAAAGCT: GGAAAAAGCTC
GGAAAAAGCTC: GAAAAAGCTCT
GAAAAAGCTCT: AAAAAGCTCTT
AAAAAGCTCTT: AAAAGCTCTTC
AAAAGCTCTTC: AAAGCTCTTCA
AAAGCTCTTCA: AAGCTCTTCAT
AAGCTCTTCAT: AGCTCTTCATG
AGCTCTTCATG: GCTCTTCATGT
GCTCTTCATGT: CTCTTCATGTT
CTCTTCATGTT: TCTTCATGTTC
TCTTCATGTTC: CTTCATGTTCT
CTTCATGTTCT: TTCATGTTCTC
TTCATGTTCTC: TCATGTTCTCA
TCATGTTCTCA: CATGTTCTCAT
CATGTTCTCAT: ATGTTCTCATA
ATGTTCTCATA: TGTTCTCATAT
TGTTCTCATAT: GTTCTCATATT
GTTCTCATATT: TTCTCATATTT
TTCTCATATTT: TCTCATATTTA
TCTCATATTTA: CTCATATTTAT
CTCATATTTAT: TCATATTTATT
TCATATTTATT: CATATTTATTC
CATATTTATTC: ATATTTATTCC
ATATTTATTCC: TATTTATTCCA
TATTTATTCCA: ATTTATTCCAT
ATTTATTCCAT: TTTATTCCATG
TTTATTCCATG: TTATTCCATGT
TTATTCCATGT: TATTCCATGTC
TATTCCATGTC: ATTCCATGTCC
ATTCCATGTCC: TTCCATGTCCA
TTCCATGTCCA: TCCATGTCCAC
TCCATGTCCAC: CCATGTCCACT
CCATGTCCACT: CATGTCCACTC
CATGTCCACTC: ATGTCCACTCC
ATGTCCACTCC: TGTCCACTCCA
TGTCCACTCCA: GTCCACTCCAG
GTCCACTCCAG: TCCACTCCAGC
TCCACTCCAGC: CCACTCCAGCA
CCACTCCAGCA: CACTCCAGCAG
CACTCCAGCAG: ACTCCAGCAGT
ACTCCAGCAGT: CTCCAGCAGTT
CTCCAGCAGTT: TCCAGCAGTTC
TCCAGCAGTTC: CCAGCAGTTCC
CCAGCAGTTCC: CAGCAGTTCCC
CAGCAGTTCCC: AGCAGTTCCCG
AGCAGTTCCCG: GCAGTTCCCGG
GCAGTTCCCGG: CAGTTCCCGGC
CAGTTCCCGGC: AGTTCCCGGCG
AGTTCCCGGCG: GTTCCCGGCGT
GTTCCCGGCGT: TTCCCGGCGTA
TTCCCGGCGTA: TCCCGGCGTAC
TCCCGGCGTAC: CCCGGCGTACC
CCCGGCGTACC: CCGGCGTACCC
CCGGCGTACCC: CGGCGTACCCC
CGGCGTACCCC: GGCGTACCCCG
GGCGTACCCCG: GCGTACCCCGC
GCGTACCCCGC: CGTACCCCGCC
CGTACCCCGCC: GTACCCCGCCA
GTACCCCGCCA: TACCCCGCCAT
TACCCCGCCAT: ACCCCGCCATA
ACCCCGCCATA: CCCCGCCATAC
CCCCGCCATAC: CCCGCCATACT
CCCGCCATACT: CCGCCATACTC
CCGCCATACTC: CGCCATACTCG
CGCCATACTCG: GCCATACTCGC
GCCATACTCGC: CCATACTCGCA
CCATACTCGCA: CATACTCGCAG
CATACTCGCAG: ATACTCGCAGA
ATACTCGCAGA: TACTCGCAGAA
TACTCGCAGAA: ACTCGCAGAAT
ACTCGCAGAAT: CTCGCAGAATC
CTCGCAGAATC: TCGCAGAATCC
TCGCAGAATCC: CGCAGAATCCA
CGCAGAATCCA: GCAGAATCCAA
GCAGAATCCAA: CAGAATCCAAT
CAGAATCCAAT: AGAATCCAATC
AGAATCCAATC: GAATCCAATCA
GAATCCAATCA: AATCCAATCAA
AATCCAATCAA: ATCCAATCAAA
ATCCAATCAAA: TCCAATCAAAG
TCCAATCAAAG: CCAATCAAAGC
CCAATCAAAGC: CAATCAAAGCA
CAATCAAAGCA: AATCAAAGCAG
AATCAAAGCAG: ATCAAAGCAGG
ATCAAAGCAGG: TCAAAGCAGGT
TCAAAGCAGGT: CAAAGCAGGTT
CAAAGCAGGTT: AAAGCAGGTTG
AAAGCAGGTTG: AAGCAGGTTGG
AAGCAGGTTGG: AGCAGGTTGGA
AGCAGGTTGGA: GCAGGTTGGAG
GCAGGTTGGAG: CAGGTTGGAGA
CAGGTTGGAGA: AGGTTGGAGAG
AGGTTGGAGAG: GGTTGGAGAGA
GGTTGGAGAGA: GTTGGAGAGAC
GTTGGAGAGAC: TTGGAGAGACC
TTGGAGAGACC: TGGAGAGACCT
TGGAGAGACCT: GGAGAGACCTT
GGAGAGACCTT: GAGAGACCTTA
GAGAGACCTTA: AGAGACCTTAC
AGAGACCTTAC: GAGACCTTACC
GAGACCTTACC: AGACCTTACCC
AGACCTTACCC: GACCTTACCCC
GACCTTACCCC: ACCTTACCCCA
ACCTTACCCCA: CCTTACCCCAC
CCTTACCCCAC: CTTACCCCACT
CTTACCCCACT: TTACCCCACTG
TTACCCCACTG: TACCCCACTGA
TACCCCACTGA: ACCCCACTGAC
ACCCCACTGAC: CCCCACTGACC
CCCCACTGACC: CCCACTGACCT
CCCACTGACCT: CCACTGACCTA
CCACTGACCTA: CACTGACCTAC
CACTGACCTAC: ACTGACCTACC
ACTGACCTACC: CTGACCTACCA
CTGACCTACCA: TGACCTACCAA
TGACCTACCAA: GACCTACCAAA
GACCTACCAAA: ACCTACCAAAG
ACCTACCAAAG: CCTACCAAAGA
CCTACCAAAGA: CTACCAAAGAA
CTACCAAAGAA: TACCAAAGAAG
TACCAAAGAAG: ACCAAAGAAGT
ACCAAAGAAGT: CCAAAGAAGTG
CCAAAGAAGTG: CAAAGAAGTGC
CAAAGAAGTGC: AAAGAAGTGCC
AAAGAAGTGCC: AAGAAGTGCCG
AAGAAGTGCCG: AGAAGTGCCGG
AGAAGTGCCGG: GAAGTGCCGGG
GAAGTGCCGGG: AAGTGCCGGGA
AAGTGCCGGGA: AGTGCCGGGAT
AGTGCCGGGAT: GTGCCGGGATA
GTGCCGGGATA: TGCCGGGATAC
TGCCGGGATAC: GCCGGGATACC
GCCGGGATACC: CCGGGATACCT
CCGGGATACCT: CGGGATACCTT
CGGGATACCTT: GGGATACCTTG
GGGATACCTTG: GGATACCTTGC
GGATACCTTGC: GATACCTTGCG
GATACCTTGCG: ATACCTTGCGT
ATACCTTGCGT: TACCTTGCGTA
TACCTTGCGTA: ACCTTGCGTAG
ACCTTGCGTAG: CCTTGCGTAGA
CCTTGCGTAGA: CTTGCGTAGAA
CTTGCGTAGAA: TTGCGTAGAAG
TTGCGTAGAAG: TGCGTAGAAGT
TGCGTAGAAGT: GCGTAGAAGTG
GCGTAGAAGTG: CGTAGAAGTGC
CGTAGAAGTGC: GTAGAAGTGCG
GTAGAAGTGCG: TAGAAGTGCGC
TAGAAGTGCGC: AGAAGTGCGCA
AGAAGTGCGCA: GAAGTGCGCAT
GAAGTGCGCAT: AAGTGCGCATC
AAGTGCGCATC: AGTGCGCATCA
AGTGCGCATCA: GTGCGCATCAT
GTGCGCATCAT: TGCGCATCATT
TGCGCATCATT: GCGCATCATTG
GCGCATCATTG: CGCATCATTGC
CGCATCATTGC: GCATCATTGCT
GCATCATTGCT: CATCATTGCTG
CATCATTGCTG: ATCATTGCTGC
ATCATTGCTGC: TCATTGCTGCA
TCATTGCTGCA: CATTGCTGCAA
CATTGCTGCAA: ATTGCTGCAAC
ATTGCTGCAAC: TTGCTGCAACC
TTGCTGCAACC: TGCTGCAACCA
TGCTGCAACCA: GCTGCAACCAA
GCTGCAACCAA: CTGCAACCAAT
CTGCAACCAAT: TGCAACCAATA
TGCAACCAATA: GCAACCAATAC
GCAACCAATAC: CAACCAATACC
CAACCAATACC: AACCAATACCG
AACCAATACCG: ACCAATACCGT
ACCAATACCGT: CCAATACCGTT
CCAATACCGTT: CAATACCGTTG
CAATACCGTTG: AATACCGTTGC
AATACCGTTGC: ATACCGTTGCG
ATACCGTTGCG: TACCGTTGCGT
TACCGTTGCGT: ACCGTTGCGTC
ACCGTTGCGTC: CCGTTGCGTCG
CCGTTGCGTCG: CGTTGCGTCGG
CGTTGCGTCGG: GTTGCGTCGGT
GTTGCGTCGGT: TTGCGTCGGTT
TTGCGTCGGTT: TGCGTCGGTTG
TGCGTCGGTTG: GCGTCGGTTGC
GCGTCGGTTGC: CGTCGGTTGCT
CGTCGGTTGCT: GTCGGTTGCTC
GTCGGTTGCTC: TCGGTTGCTCG
TCGGTTGCTCG: CGGTTGCTCGA
CGGTTGCTCGA: GGTTGCTCGAG
GGTTGCTCGAG: GTTGCTCGAGA
GTTGCTCGAGA: TTGCTCGAGAC
TTGCTCGAGAC: TGCTCGAGACT
TGCTCGAGACT: GCTCGAGACTA
GCTCGAGACTA: CTCGAGACTAT
CTCGAGACTAT: TCGAGACTATA
TCGAGACTATA: CGAGACTATAT
CGAGACTATAT: GAGACTATATT
GAGACTATATT: AGACTATATTC
AGACTATATTC: GACTATATTCG
GACTATATTCG: ACTATATTCGC
ACTATATTCGC: CTATATTCGCT
CTATATTCGCT: TATATTCGCTA
TATATTCGCTA: ATATTCGCTAG
ATATTCGCTAG: TATTCGCTAGT
TATTCGCTAGT: ATTCGCTAGTC
ATTCGCTAGTC: TTCGCTAGTCT
TTCGCTAGTCT: TCGCTAGTCTA
TCGCTAGTCTA: CGCTAGTCTAT
CGCTAGTCTAT: GCTAGTCTATC
GCTAGTCTATC: CTAGTCTATCT
CTAGTCTATCT: TAGTCTATCTC
TAGTCTATCTC: AGTCTATCTCA
AGTCTATCTCA: GTCTATCTCAA
GTCTATCTCAA: TCTATCTCAAC
TCTATCTCAAC: CTATCTCAACT
CTATCTCAACT: TATCTCAACTT
TATCTCAACTT: ATCTCAACTTG
ATCTCAACTTG: TCTCAACTTGG
TCTCAACTTGG: CTCAACTTGGG
CTCAACTTGGG: TCAACTTGGGA
TCAACTTGGGA: CAACTTGGGAT
CAACTTGGGAT: AACTTGGGATC
AACTTGGGATC: ACTTGGGATCT
ACTTGGGATCT: CTTGGGATCTA
CTTGGGATCTA: TTGGGATCTAT
TTGGGATCTAT: TGGGATCTATT
TGGGATCTATT: GGGATCTATTT
GGGATCTATTT: GGATCTATTTA
GGATCTATTTA: GATCTATTTAG
GATCTATTTAG: ATCTATTTAGT
ATCTATTTAGT: TCTATTTAGTC
TCTATTTAGTC: CTATTTAGTCC
CTATTTAGTCC: TATTTAGTCCC
TATTTAGTCCC: ATTTAGTCCCG
ATTTAGTCCCG: TTTAGTCCCGC
TTTAGTCCCGC: TTAGTCCCGCA
TTAGTCCCGCA: TAGTCCCGCAA
TAGTCCCGCAA: AGTCCCGCAAA
AGTCCCGCAAA: GTCCCGCAAAT
GTCCCGCAAAT: TCCCGCAAATT
TCCCGCAAATT: CCCGCAAATTA
CCCGCAAATTA: CCGCAAATTAG
CCGCAAATTAG: CGCAAATTAGG
CGCAAATTAGG: GCAAATTAGGT
GCAAATTAGGT: CAAATTAGGTT
CAAATTAGGTT: AAATTAGGTTT
AAATTAGGTTT: AATTAGGTTTC
AATTAGGTTTC: ATTAGGTTTCA
ATTAGGTTTCA: TTAGGTTTCAC
TTAGGTTTCAC: TAGGTTTCACG
TAGGTTTCACG: AGGTTTCACGT
AGGTTTCACGT: GGTTTCACGTA
GGTTTCACGTA: GTTTCACGTAG
GTTTCACGTAG: TTTCACGTAGG
TTTCACGTAGG: TTCACGTAGGT
TTCACGTAGGT: TCACGTAGGTC
TCACGTAGGTC: CACGTAGGTCA
CACGTAGGTCA: ACGTAGGTCAT
ACGTAGGTCAT: CGTAGGTCATG
CGTAGGTCATG: GTAGGTCATGA
GTAGGTCATGA: TAGGTCATGAC
TAGGTCATGAC: AGGTCATGACC
AGGTCATGACC: GGTCATGACCG
GGTCATGACCG: GTCATGACCGT
GTCATGACCGT: TCATGACCGTT
TCATGACCGTT: CATGACCGTTT
CATGACCGTTT: ATGACCGTTTG
ATGACCGTTTG: TGACCGTTTGA
TGACCGTTTGA: GACCGTTTGAT
GACCGTTTGAT: ACCGTTTGATT
ACCGTTTGATT: CCGTTTGATTT
CCGTTTGATTT: CGTTTGATTTT
CGTTTGATTTT: GTTTGATTTTC
GTTTGATTTTC: TTTGATTTTCG
TTTGATTTTCG: TTGATTTTCGA
TTGATTTTCGA: TGATTTTCGAT
TGATTTTCGAT: GATTTTCGATG
GATTTTCGATG: ATTTTCGATGT
ATTTTCGATGT: TTTTCGATGTA
TTTTCGATGTA: TTTCGATGTAG
TTTCGATGTAG: TTCGATGTAGA
TTCGATGTAGA: TCGATGTAGAG
TCGATGTAGAG: CGATGTAGAGC
CGATGTAGAGC: GATGTAGAGCT
GATGTAGAGCT: ATGTAGAGCTC
ATGTAGAGCTC: TGTAGAGCTCT
TGTAGAGCTCT: GTAGAGCTCTT
GTAGAGCTCTT: TAGAGCTCTTG
TAGAGCTCTTG: AGAGCTCTTGC
AGAGCTCTTGC: GAGCTCTTGCG
GAGCTCTTGCG: AGCTCTTGCGG
AGCTCTTGCGG: GCTCTTGCGGT
GCTCTTGCGGT: CTCTTGCGGTC
CTCTTGCGGTC: TCTTGCGGTCC
TCTTGCGGTCC: CTTGCGGTCCA
CTTGCGGTCCA: TTGCGGTCCAT
TTGCGGTCCAT: TGCGGTCCATG
TGCGGTCCATG: GCGGTCCATGA
GCGGTCCATGA: CGGTCCATGAC
CGGTCCATGAC: GGTCCATGACT
GGTCCATGACT: GTCCATGACTT
GTCCATGACTT: TCCATGACTTA
TCCATGACTTA: CCATGACTTAG
CCATGACTTAG: CATGACTTAGT
CATGACTTAGT: ATGACTTAGTC
ATGACTTAGTC: TGACTTAGTCG
TGACTTAGTCG: GACTTAGTCGA
GACTTAGTCGA: ACTTAGTCGAC
ACTTAGTCGAC: CTTAGTCGACA
CTTAGTCGACA: TTAGTCGACAG
TTAGTCGACAG: TAGTCGACAGA
TAGTCGACAGA: AGTCGACAGAA
AGTCGACAGAA: GTCGACAGAAG
GTCGACAGAAG: TCGACAGAAGA
TCGACAGAAGA: CGACAGAAGAT
CGACAGAAGAT: GACAGAAGATG
GACAGAAGATG: ACAGAAGATGC
ACAGAAGATGC: CAGAAGATGCC
CAGAAGATGCC: AGAAGATGCCC
AGAAGATGCCC: GAAGATGCCCT
GAAGATGCCCT: AAGATGCCCTG
AAGATGCCCTG: AGATGCCCTGT
AGATGCCCTGT: GATGCCCTGTA
GATGCCCTGTA: ATGCCCTGTAT
ATGCCCTGTAT: TGCCCTGTATG
TGCCCTGTATG: GCCCTGTATGG
GCCCTGTATGG: CCCTGTATGGG
CCCTGTATGGG: CCTGTATGGGT
CCTGTATGGGT: CTGTATGGGTA
CTGTATGGGTA: TGTATGGGTAT
TGTATGGGTAT: GTATGGGTATT
GTATGGGTATT: TATGGGTATTC
TATGGGTATTC: ATGGGTATTCG
ATGGGTATTCG: TGGGTATTCGC
TGGGTATTCGC: GGGTATTCGCG
GGGTATTCGCG: GGTATTCGCGG
GGTATTCGCGG: GTATTCGCGGG
GTATTCGCGGG: TATTCGCGGGT
TATTCGCGGGT: ATTCGCGGGTC
ATTCGCGGGTC: TTCGCGGGTCG
TTCGCGGGTCG: TCGCGGGTCGC
TCGCGGGTCGC: CGCGGGTCGCA
CGCGGGTCGCA: GCGGGTCGCAT
GCGGGTCGCAT: CGGGTCGCATC
CGGGTCGCATC: GGGTCGCATCT
GGGTCGCATCT: GGTCGCATCTA
GGTCGCATCTA: GTCGCATCTAC
GTCGCATCTAC: TCGCATCTACC
TCGCATCTACC: CGCATCTACCC
CGCATCTACCC: GCATCTACCCA
GCATCTACCCA: CATCTACCCAG
CATCTACCCAG: ATCTACCCAGA
ATCTACCCAGA: TCTACCCAGAT
TCTACCCAGAT: CTACCCAGATA
CTACCCAGATA: TACCCAGATAC
TACCCAGATAC: ACCCAGATACG
ACCCAGATACG: CCCAGATACGC
CCCAGATACGC: CCAGATACGCA
CCAGATACGCA: CAGATACGCAA
CAGATACGCAA: AGATACGCAAT
AGATACGCAAT: GATACGCAATG
GATACGCAATG: ATACGCAATGG
ATACGCAATGG: TACGCAATGGT
TACGCAATGGT: ACGCAATGGTA
ACGCAATGGTA: CGCAATGGTAA
CGCAATGGTAA: GCAATGGTAAG
GCAATGGTAAG: CAATGGTAAGC
CAATGGTAAGC: AATGGTAAGCC
AATGGTAAGCC: ATGGTAAGCCC
ATGGTAAGCCC: TGGTAAGCCCA
TGGTAAGCCCA: GGTAAGCCCAA
GGTAAGCCCAA: GTAAGCCCAAG
GTAAGCCCAAG: TAAGCCCAAGG
TAAGCCCAAGG: AAGCCCAAGGG
AAGCCCAAGGG: AGCCCAAGGGT
AGCCCAAGGGT: GCCCAAGGGTT
GCCCAAGGGTT: CCCAAGGGTTT
CCCAAGGGTTT: CCAAGGGTTTA
CCAAGGGTTTA: CAAGGGTTTAC
CAAGGGTTTAC: AAGGGTTTACC
AAGGGTTTACC: AGGGTTTACCA
AGGGTTTACCA: GGGTTTACCAC
GGGTTTACCAC: GGTTTACCACA
GGTTTACCACA: GTTTACCACAC
GTTTACCACAC: TTTACCACACA
TTTACCACACA: TTACCACACAC
TTACCACACAC: TACCACACACG
TACCACACACG: ACCACACACGC
ACCACACACGC: CCACACACGCG
CCACACACGCG: CACACACGCGA
CACACACGCGA: ACACACGCGAC
ACACACGCGAC: CACACGCGACG
CACACGCGACG: ACACGCGACGA
ACACGCGACGA: CACGCGACGAT
CACGCGACGAT: ACGCGACGATC
ACGCGACGATC: CGCGACGATCC
CGCGACGATCC: GCGACGATCCA
GCGACGATCCA: CGACGATCCAC
CGACGATCCAC: GACGATCCACT
GACGATCCACT: ACGATCCACTT ACGATCCACTG
ACGATCCACTT: CGATCCACTTC
CGATCCACTTC: GATCCACTTCT
GATCCACTTCT: ATCCACTTCTC
ATCCACTTCTC: TCCACTTCTCA
TCCACTTCTCA: CCACTTCTCAA
CCACTTCTCAA: CACTTCTCAAC
CACTTCTCAAC: ACTTCTCAACA
ACTTCTCAACA: CTTCTCAACAA
CTTCTCAACAA: TTCTCAACAAG
TTCTCAACAAG: TCTCAACAAGG
TCTCAACAAGG: CTCAACAAGGC
CTCAACAAGGC: TCAACAAGGCC
TCAACAAGGCC: CAACAAGGCCG
CAACAAGGCCG: AACAAGGCCGT
AACAAGGCCGT: ACAAGGCCGTC
ACAAGGCCGTC: CAAGGCCGTCA
CAAGGCCGTCA: AAGGCCGTCAG
AAGGCCGTCAG: AGGCCGTCAGA
AGGCCGTCAGA: GGCCGTCAGAT
GGCCGTCAGAT: GCCGTCAGATG
GCCGTCAGATG: CCGTCAGATGA
CCGTCAGATGA: CGTCAGATGAA
CGTCAGATGAA: GTCAGATGAAT
GTCAGATGAAT: TCAGATGAATG
TCAGATGAATG: CAGATGAATGC
CAGATGAATGC: AGATGAATGCG
AGATGAATGCG: GATGAATGCGG
GATGAATGCGG: ATGAATGCGGG
ATGAATGCGGG: TGAATGCGGGA
TGAATGCGGGA: GAATGCGGGAT
GAATGCGGGAT: AATGCGGGATA
AATGCGGGATA: ATGCGGGATAG
ATGCGGGATAG: TGCGGGATAGA
TGCGGGATAGA: GCGGGATAGAG
GCGGGATAGAG: CGGGATAGAGT
CGGGATAGAGT: GGGATAGAGTT
GGGATAGAGTT: GGATAGAGTTA
GGATAGAGTTA: GATAGAGTTAA
GATAGAGTTAA: ATAGAGTTAAA
ATAGAGTTAAA: TAGAGTTAAAG
TAGAGTTAAAG: AGAGTTAAAGC
AGAGTTAAAGC: GAGTTAAAGCA
GAGTTAAAGCA: AGTTAAAGCAA
AGTTAAAGCAA: GTTAAAGCAAT
GTTAAAGCAAT: TTAAAGCAATC
TTAAAGCAATC: TAAAGCAATCA
TAAAGCAATCA: AAAGCAATCAT
AAAGCAATCAT: AAGCAATCATA
AAGCAATCATA: AGCAATCATAT
AGCAATCATAT: GCAATCATATT
GCAATCATATT: CAATCATATTG
CAATCATATTG: AATCATATTGT
AATCATATTGT: ATCATATTGTC
ATCATATTGTC: TCATATTGTCG
TCATATTGTCG: CATATTGTCGA
CATATTGTCGA: ATATTGTCGAC
ATATTGTCGAC: TATTGTCGACC
TATTGTCGACC: ATTGTCGACCA
ATTGTCGACCA: TTGTCGACCAA
TTGTCGACCAA: TGTCGACCAAC
TGTCGACCAAC: GTCGACCAACT
GTCGACCAACT: TCGACCAACTC
TCGACCAACTC: CGACCAACTCC
CGACCAACTCC: GACCAACTCCG
GACCAACTCCG: ACCAACTCCGC
ACCAACTCCGC: CCAACTCCGCT
CCAACTCCGCT: CAACTCCGCTT
CAACTCCGCTT: AACTCCGCTTT
AACTCCGCTTT: ACTCCGCTTTC
ACTCCGCTTTC: CTCCGCTTTCC
CTCCGCTTTCC: TCCGCTTTCCT
TCCGCTTTCCT: CCGCTTTCCTG
CCGCTTTCCTG: CGCTTTCCTGA
CGCTTTCCTGA: GCTTTCCTGAC
GCTTTCCTGAC: CTTTCCTGACA
CTTTCCTGACA: TTTCCTGACAT
TTTCCTGACAT: TTCCTGACATG
TTCCTGACATG: TCCTGACATGA
TCCTGACATGA: CCTGACATGAA
CCTGACATGAA: CTGACATGAAG
CTGACATGAAG: TGACATGAAGC
TGACATGAAGC: GACATGAAGCC
GACATGAAGCC: ACATGAAGCCC
ACATGAAGCCC: CATGAAGCCCG
CATGAAGCCCG: ATGAAGCCCGT
ATGAAGCCCGT: TGAAGCCCGTG
TGAAGCCCGTG: GAAGCCCGTGC
GAAGCCCGTGC: AAGCCCGTGCC
AAGCCCGTGCC: AGCCCGTGCCA
AGCCCGTGCCA: GCCCGTGCCAT
GCCCGTGCCAT: CCCGTGCCATG
CCCGTGCCATG: CCGTGCCATGC
CCGTGCCATGC: CGTGCCATGCT
CGTGCCATGCT: GTGCCATGCTA
GTGCCATGCTA: TGCCATGCTAG
TGCCATGCTAG: GCCATGCTAGC
GCCATGCTAGC: CCATGCTAGCG
CCATGCTAGCG: CATGCTAGCGA
CATGCTAGCGA: ATGCTAGCGAA
ATGCTAGCGAA: TGCTAGCGAAT
TGCTAGCGAAT: GCTAGCGAATT
GCTAGCGAATT: CTAGCGAATTC
CTAGCGAATTC: TAGCGAATTCG
TAGCGAATTCG: AGCGAATTCGA
AGCGAATTCGA: GCGAATTCGAA
GCGAATTCGAA: CGAATTCGAAG
CGAATTCGAAG: GAATTCGAAGT
GAATTCGAAGT: AATTCGAAGTA
AATTCGAAGTA: ATTCGAAGTAT
ATTCGAAGTAT: TTCGAAGTATG
TTCGAAGTATG: TCGAAGTATGT
TCGAAGTATGT: CGAAGTATGTT
CGAAGTATGTT: GAAGTATGTTC
GAAGTATGTTC: AAGTATGTTCA
AAGTATGTTCA: AGTATGTTCAA
AGTATGTTCAA: GTATGTTCAAT
GTATGTTCAAT: TATGTTCAATG
TATGTTCAATG: ATGTTCAATGA
ATGTTCAATGA: TGTTCAATGAA
TGTTCAATGAA: GTTCAATGAAA
GTTCAATGAAA: TTCAATGAAAA
TTCAATGAAAA: TCAATGAAAAT
TCAATGAAAAT: CAATGAAAATA
CAATGAAAATA: AATGAAAATAG
AATGAAAATAG: ATGAAAATAGG
ATGAAAATAGG: TGAAAATAGGA
TGAAAATAGGA: GAAAATAGGAC
GAAAATAGGAC: AAAATAGGACG
AAAATAGGACG: AAATAGGACGA
AAATAGGACGA: AATAGGACGAT
AATAGGACGAT: ATAGGACGATC
ATAGGACGATC: TAGGACGATCC
TAGGACGATCC: AGGACGATCCA
AGGACGATCCA: GGACGATCCAC
GGACGATCCAC: GACGATCCACT
ACGATCCACTG: CGATCCACTGA
CGATCCACTGA: GATCCACTGAC
GATCCACTGAC: ATCCACTGACA
ATCCACTGACA: TCCACTGACAC
TCCACTGACAC: CCACTGACACG
CCACTGACACG: CACTGACACGG
CACTGACACGG: ACTGACACGGC
ACTGACACGGC: CTGACACGGCA
CTGACACGGCA: TGACACGGCAA
TGACACGGCAA: GACACGGCAAT
GACACGGCAAT: ACACGGCAATA
ACACGGCAATA: CACGGCAATAG
CACGGCAATAG: ACGGCAATAGG
ACGGCAATAGG: CGGCAATAGGT
CGGCAATAGGT: GGCAATAGGTG
GGCAATAGGTG: GCAATAGGTGT
GCAATAGGTGT: CAATAGGTGTA
CAATAGGTGTA: AATAGGTGTAT
AATAGGTGTAT: ATAGGTGTATT
ATAGGTGTATT: TAGGTGTATTC
TAGGTGTATTC: AGGTGTATTCA
AGGTGTATTCA: GGTGTATTCAC
GGTGTATTCAC: GTGTATTCACC
GTGTATTCACC: TGTATTCACCA
TGTATTCACCA: GTATTCACCAT
GTATTCACCAT: TATTCACCATA
TATTCACCATA: ATTCACCATAT
ATTCACCATAT: TTCACCATATG
TTCACCATATG: TCACCATATGT
TCACCATATGT: CACCATATGTT
CACCATATGTT: ACCATATGTTC
ACCATATGTTC: CCATATGTTCC
CCATATGTTCC: CATATGTTCCA
CATATGTTCCA: ATATGTTCCAC
ATATGTTCCAC: TATGTTCCACG
TATGTTCCACG: ATGTTCCACGG
ATGTTCCACGG: TGTTCCACGGG
TGTTCCACGGG: GTTCCACGGGG
GTTCCACGGGG: TTCCACGGGGC
TTCCACGGGGC: TCCACGGGGCC
TCCACGGGGCC: CCACGGGGCCT
CCACGGGGCCT: CACGGGGCCTC
CACGGGGCCTC: ACGGGGCCTCA
ACGGGGCCTCA: CGGGGCCTCAA
CGGGGCCTCAA: GGGGCCTCAAG
GGGGCCTCAAG: GGGCCTCAAGC
GGGCCTCAAGC: GGCCTCAAGCC
GGCCTCAAGCC: GCCTCAAGCCC
GCCTCAAGCCC: CCTCAAGCCCA
CCTCAAGCCCA: CTCAAGCCCAT
CTCAAGCCCAT: TCAAGCCCATC
TCAAGCCCATC: CAAGCCCATCT
CAAGCCCATCT: AAGCCCATCTT
AAGCCCATCTT: AGCCCATCTTG
AGCCCATCTTG: GCCCATCTTGG
GCCCATCTTGG: CCCATCTTGGC
CCCATCTTGGC: CCATCTTGGCT
CCATCTTGGCT: CATCTTGGCTG
CATCTTGGCTG: ATCTTGGCTGT
ATCTTGGCTGT: TCTTGGCTGTG
TCTTGGCTGTG: CTTGGCTGTGA
CTTGGCTGTGA: TTGGCTGTGAG
TTGGCTGTGAG: TGGCTGTGAGA
TGGCTGTGAGA: GGCTGTGAGAG
GGCTGTGAGAG: GCTGTGAGAGC
GCTGTGAGAGC: CTGTGAGAGCT
CTGTGAGAGCT: TGTGAGAGCTA
TGTGAGAGCTA: GTGAGAGCTAA
GTGAGAGCTAA: TGAGAGCTAAG
TGAGAGCTAAG: GAGAGCTAAGT
GAGAGCTAAGT: AGAGCTAAGTA
AGAGCTAAGTA: GAGCTAAGTAT
GAGCTAAGTAT: AGCTAAGTATA
AGCTAAGTATA: GCTAAGTATAA
GCTAAGTATAA: CTAAGTATAAG
CTAAGTATAAG: TAAGTATAAGC
TAAGTATAAGC: AAGTATAAGCT
AAGTATAAGCT: AGTATAAGCTG
AGTATAAGCTG: GTATAAGCTGA
GTATAAGCTGA: TATAAGCTGAA
TATAAGCTGAA: ATAAGCTGAAT
ATAAGCTGAAT: TAAGCTGAATA
TAAGCTGAATA: AAGCTGAATAC
AAGCTGAATAC: AGCTGAATACA
AGCTGAATACA: GCTGAATACAC
GCTGAATACAC: CTGAATACACT
CTGAATACACT: TGAATACACTG
TGAATACACTG: GAATACACTGG
GAATACACTGG: AATACACTGGT
AATACACTGGT: ATACACTGGTT
ATACACTGGTT: TACACTGGTTC
TACACTGGTTC: ACACTGGTTCA
ACACTGGTTCA: CACTGGTTCAT
CACTGGTTCAT: ACTGGTTCATA
ACTGGTTCATA: CTGGTTCATAC
CTGGTTCATAC: TGGTTCATACT
TGGTTCATACT: GGTTCATACTG
GGTTCATACTG: GTTCATACTGG
GTTCATACTGG: TTCATACTGGA
TTCATACTGGA: TCATACTGGAG
TCATACTGGAG: CATACTGGAGC
CATACTGGAGC: ATACTGGAGCC
ATACTGGAGCC: TACTGGAGCCC
TACTGGAGCCC: ACTGGAGCCCG
ACTGGAGCCCG: CTGGAGCCCGG
CTGGAGCCCGG: TGGAGCCCGGC
TGGAGCCCGGC: GGAGCCCGGCC
GGAGCCCGGCC: GAGCCCGGCCT
GAGCCCGGCCT: AGCCCGGCCTT
AGCCCGGCCTT: GCCCGGCCTTG
GCCCGGCCTTG: CCCGGCCTTGC
CCCGGCCTTGC: CCGGCCTTGCT
CCGGCCTTGCT: CGGCCTTGCTT
CGGCCTTGCTT: GGCCTTGCTTG
GGCCTTGCTTG: GCCTTGCTTGT
GCCTTGCTTGT: CCTTGCTTGTG
CCTTGCTTGTG: CTTGCTTGTGT
CTTGCTTGTGT: TTGCTTGTGTG
TTGCTTGTGTG: TGCTTGTGTGA
TGCTTGTGTGA: GCTTGTGTGAC
GCTTGTGTGAC: CTTGTGTGACT
CTTGTGTGACT: TTGTGTGACTA
TTGTGTGACTA: TGTGTGACTAC
TGTGTGACTAC: GTGTGACTACG
GTGTGACTACG: TGTGACTACGA
TGTGACTACGA: GTGACTACGAT
GTGACTACGAT: TGACTACGATC
TGACTACGATC: GACTACGATCG
GACTACGATCG: ACTACGATCGC
ACTACGATCGC: CTACGATCGCC
CTACGATCGCC: TACGATCGCCG
TACGATCGCCG: ACGATCGCCGG
ACGATCGCCGG: CGATCGCCGGC
CGATCGCCGGC: GATCGCCGGCC
GATCGCCGGCC: ATCGCCGGCCC
ATCGCCGGCCC: TCGCCGGCCCA
TCGCCGGCCCA: CGCCGGCCCAT
CGCCGGCCCAT: GCCGGCCCATT
GCCGGCCCATT: CCGGCCCATTA
CCGGCCCATTA: CGGCCCATTAA
CGGCCCATTAA: GGCCCATTAAC
GGCCCATTAAC: GCCCATTAACC
GCCCATTAACC: CCCATTAACCA
CCCATTAACCA: CCATTAACCAA
CCATTAACCAA: CATTAACCAAA
CATTAACCAAA: ATTAACCAAAC
ATTAACCAAAC: TTAACCAAACT
TTAACCAAACT: TAACCAAACTA
TAACCAAACTA: AACCAAACTAC
AACCAAACTAC: ACCAAACTACT
ACCAAACTACT: CCAAACTACTC
CCAAACTACTC: CAAACTACTCA
CAAACTACTCA: AAACTACTCAC
AAACTACTCAC: AACTACTCACT
AACTACTCACT: ACTACTCACTT
ACTACTCACTT: CTACTCACTTA
CTACTCACTTA: TACTCACTTAT
TACTCACTTAT: ACTCACTTATA
ACTCACTTATA: CTCACTTATAG
CTCACTTATAG: TCACTTATAGT
TCACTTATAGT: CACTTATAGTT
CACTTATAGTT: ACTTATAGTTC
ACTTATAGTTC: CTTATAGTTCT
CTTATAGTTCT: TTATAGTTCTT
TTATAGTTCTT: TATAGTTCTTA
TATAGTTCTTA: ATAGTTCTTAG
ATAGTTCTTAG: TAGTTCTTAGC
TAGTTCTTAGC: AGTTCTTAGCA
AGTTCTTAGCA: GTTCTTAGCAG
GTTCTTAGCAG: TTCTTAGCAGA
TTCTTAGCAGA: TCTTAGCAGAG
TCTTAGCAGAG: CTTAGCAGAGG
CTTAGCAGAGG: TTAGCAGAGGC
TTAGCAGAGGC: TAGCAGAGGCT
TAGCAGAGGCT: AGCAGAGGCTT
AGCAGAGGCTT: GCAGAGGCTTC
GCAGAGGCTTC: CAGAGGCTTCA
CAGAGGCTTCA: AGAGGCTTCAG
AGAGGCTTCAG: GAGGCTTCAGC
GAGGCTTCAGC: AGGCTTCAGCA
AGGCTTCAGCA: GGCTTCAGCAT
GGCTTCAGCAT: GCTTCAGCATA
GCTTCAGCATA: CTTCAGCATAT
CTTCAGCATAT: TTCAGCATATT
TTCAGCATATT: TCAGCATATTT
TCAGCATATTT: CAGCATATTTG
CAGCATATTTG: AGCATATTTGT
AGCATATTTGT: GCATATTTGTT
GCATATTTGTT: CATATTTGTTC
CATATTTGTTC: ATATTTGTTCT
ATATTTGTTCT: TATTTGTTCTA
TATTTGTTCTA: ATTTGTTCTAT
ATTTGTTCTAT: TTTGTTCTATC
TTTGTTCTATC: TTGTTCTATCC
TTGTTCTATCC: TGTTCTATCCT
TGTTCTATCCT: GTTCTATCCTC
GTTCTATCCTC: TTCTATCCTCT
TTCTATCCTCT: TCTATCCTCTC
TCTATCCTCTC: CTATCCTCTCA
CTATCCTCTCA: TATCCTCTCAC
TATCCTCTCAC: ATCCTCTCACG
ATCCTCTCACG: TCCTCTCACGT
TCCTCTCACGT: CCTCTCACGTC
CCTCTCACGTC: CTCTCACGTCT
CTCTCACGTCT: TCTCACGTCTC
TCTCACGTCTC: CTCACGTCTCC
CTCACGTCTCC: TCACGTCTCCT
TCACGTCTCCT: CACGTCTCCTT
CACGTCTCCTT: ACGTCTCCTTG
ACGTCTCCTTG: CGTCTCCTTGT
CGTCTCCTTGT: GTCTCCTTGTA
GTCTCCTTGTA: TCTCCTTGTAA
TCTCCTTGTAA: CTCCTTGTAAG
CTCCTTGTAAG: TCCTTGTAAGG
TCCTTGTAAGG: CCTTGTAAGGA
CCTTGTAAGGA: CTTGTAAGGAA
CTTGTAAGGAA: TTGTAAGGAAC
TTGTAAGGAAC: TGTAAGGAACA
TGTAAGGAACA: GTAAGGAACAA
GTAAGGAACAA: TAAGGAACAAC
TAAGGAACAAC: AAGGAACAACG
AAGGAACAACG: AGGAACAACGA
AGGAACAACGA: GGAACAACGAG
GGAACAACGAG: GAACAACGAGC
GAACAACGAGC: AACAACGAGCA
AACAACGAGCA: ACAACGAGCAG
ACAACGAGCAG: CAACGAGCAGT
CAACGAGCAGT: AACGAGCAGTC
AACGAGCAGTC: ACGAGCAGTCA
ACGAGCAGTCA: CGAGCAGTCAA
CGAGCAGTCAA: GAGCAGTCAAA
GAGCAGTCAAA: AGCAGTCAAAG
AGCAGTCAAAG: GCAGTCAAAGA
GCAGTCAAAGA: CAGTCAAAGAT
CAGTCAAAGAT: AGTCAAAGATA
AGTCAAAGATA: GTCAAAGATAC
GTCAAAGATAC: TCAAAGATACA
TCAAAGATACA: CAAAGATACAT
CAAAGATACAT: AAAGATACATT
AAAGATACATT: AAGATACATTG
AAGATACATTG: AGATACATTGG
AGATACATTGG: GATACATTGGA
GATACATTGGA: ATACATTGGAG
ATACATTGGAG: TACATTGGAGC
TACATTGGAGC: ACATTGGAGCG
ACATTGGAGCG: CATTGGAGCGT
CATTGGAGCGT: ATTGGAGCGTG
ATTGGAGCGTG: TTGGAGCGTGG
TTGGAGCGTGG: TGGAGCGTGGT
TGGAGCGTGGT: GGAGCGTGGTG
GGAGCGTGGTG: GAGCGTGGTGG
GAGCGTGGTGG: AGCGTGGTGGT
AGCGTGGTGGT: GCGTGGTGGTG
GCGTGGTGGTG: CGTGGTGGTGA
CGTGGTGGTGA: GTGGTGGTGAT
GTGGTGGTGAT: TGGTGGTGATA
TGGTGGTGATA: GGTGGTGATAT
GGTGGTGATAT: GTGGTGATATG
GTGGTGATATG: TGGTGATATGT
TGGTGATATGT: GGTGATATGTT
GGTGATATGTT: GTGATATGTTT
GTGATATGTTT: TGATATGTTTG
TGATATGTTTG: GATATGTTTGT
GATATGTTTGT: ATATGTTTGTC
ATATGTTTGTC: TATGTTTGTCA
TATGTTTGTCA: ATGTTTGTCAG
ATGTTTGTCAG: TGTTTGTCAGC
TGTTTGTCAGC: GTTTGTCAGCC
GTTTGTCAGCC: TTTGTCAGCCG
TTTGTCAGCCG: TTGTCAGCCGT
TTGTCAGCCGT: TGTCAGCCGTT
TGTCAGCCGTT: GTCAGCCGTTG
GTCAGCCGTTG: TCAGCCGTTGT
TCAGCCGTTGT: CAGCCGTTGTA
CAGCCGTTGTA: AGCCGTTGTAT
AGCCGTTGTAT: GCCGTTGTATA
GCCGTTGTATA: CCGTTGTATAG
CCGTTGTATAG: CGTTGTATAGT
CGTTGTATAGT: GTTGTATAGTG
GTTGTATAGTG: TTGTATAGTGG
TTGTATAGTGG: TGTATAGTGGA
TGTATAGTGGA: GTATAGTGGAA
GTATAGTGGAA: TATAGTGGAAA
TATAGTGGAAA: ATAGTGGAAAG
ATAGTGGAAAG: TAGTGGAAAGG
TAGTGGAAAGG: AGTGGAAAGGA
AGTGGAAAGGA: GTGGAAAGGAT
GTGGAAAGGAT: TGGAAAGGATC
TGGAAAGGATC: GGAAAGGATCT
GGAAAGGATCT: GAAAGGATCTT
GAAAGGATCTT: AAAGGATCTTC
AAAGGATCTTC: AAGGATCTTCG
AAGGATCTTCG: AGGATCTTCGA
AGGATCTTCGA: GGATCTTCGAC
GGATCTTCGAC: GATCTTCGACC
GATCTTCGACC: ATCTTCGACCC
ATCTTCGACCC: TCTTCGACCCC
TCTTCGACCCC: CTTCGACCCCC
CTTCGACCCCC: TTCGACCCCCA
TTCGACCCCCA: TCGACCCCCAA
TCGACCCCCAA: CGACCCCCAAC
CGACCCCCAAC: GACCCCCAACT
GACCCCCAACT: ACCCCCAACTT
ACCCCCAACTT: CCCCCAACTTG
CCCCCAACTTG: CCCCAACTTGG
CCCCAACTTGG: CCCAACTTGGA
CCCAACTTGGA: CCAACTTGGAT
CCAACTTGGAT: CAACTTGGATT
CAACTTGGATT: AACTTGGATTG
AACTTGGATTG: ACTTGGATTGA
ACTTGGATTGA: CTTGGATTGAA
CTTGGATTGAA: TTGGATTGAAA
TTGGATTGAAA: TGGATTGAAAT
TGGATTGAAAT: GGATTGAAATA
GGATTGAAATA: GATTGAAATAC
GATTGAAATAC: ATTGAAATACC
ATTGAAATACC: TTGAAATACCC
TTGAAATACCC: TGAAATACCCG
TGAAATACCCG: GAAATACCCGC
GAAATACCCGC: AAATACCCGCT
AAATACCCGCT: AATACCCGCTC
AATACCCGCTC: ATACCCGCTCC
ATACCCGCTCC: TACCCGCTCCA
TACCCGCTCCA: ACCCGCTCCAA
ACCCGCTCCAA: CCCGCTCCAAG
CCCGCTCCAAG: CCGCTCCAAGC
CCGCTCCAAGC: CGCTCCAAGCG
CGCTCCAAGCG: GCTCCAAGCGC
GCTCCAAGCGC: CTCCAAGCGCC
CTCCAAGCGCC: TCCAAGCGCCC
TCCAAGCGCCC: CCAAGCGCCCC
CCAAGCGCCCC: CAAGCGCCCCT
CAAGCGCCCCT: AAGCGCCCCTC
AAGCGCCCCTC: AGCGCCCCTCT
AGCGCCCCTCT: GCGCCCCTCTT
GCGCCCCTCTT: CGCCCCTCTTG
CGCCCCTCTTG: GCCCCTCTTGT
GCCCCTCTTGT: CCCCTCTTGTT
CCCCTCTTGTT: CCCTCTTGTTT
CCCTCTTGTTT: CCTCTTGTTTC
CCTCTTGTTTC: CTCTTGTTTCC
CTCTTGTTTCC: TCTTGTTTCCT
TCTTGTTTCCT: CTTGTTTCCTC
CTTGTTTCCTC: TTGTTTCCTCT
TTGTTTCCTCT: TGTTTCCTCTG
TGTTTCCTCTG: GTTTCCTCTGA
GTTTCCTCTGA: TTTCCTCTGAA
TTTCCTCTGAA: TTCCTCTGAAT
TTCCTCTGAAT: TCCTCTGAATC
TCCTCTGAATC: CCTCTGAATCT
CCTCTGAATCT: CTCTGAATCTG
CTCTGAATCTG: TCTGAATCTGG
TCTGAATCTGG: CTGAATCTGGG
CTGAATCTGGG: TGAATCTGGGT
TGAATCTGGGT: GAATCTGGGTG
GAATCTGGGTG: AATCTGGGTGA
AATCTGGGTGA: ATCTGGGTGAG
ATCTGGGTGAG: TCTGGGTGAGA
TCTGGGTGAGA: CTGGGTGAGAG
CTGGGTGAGAG: TGGGTGAGAGA
TGGGTGAGAGA: GGGTGAGAGAC
GGGTGAGAGAC: GGTGAGAGACA
GGTGAGAGACA: GTGAGAGACAG
GTGAGAGACAG: TGAGAGACAGA
TGAGAGACAGA: GAGAGACAGAC
GAGAGACAGAC: AGAGACAGACG
AGAGACAGACG: GAGACAGACGT
GAGACAGACGT: AGACAGACGTC
AGACAGACGTC: GACAGACGTCG
GACAGACGTCG: ACAGACGTCGG
ACAGACGTCGG: CAGACGTCGGA
CAGACGTCGGA: AGACGTCGGAC
AGACGTCGGAC: GACGTCGGACG
GACGTCGGACG: ACGTCGGACGC
ACGTCGGACGC: CGTCGGACGCC
CGTCGGACGCC: GTCGGACGCCC
GTCGGACGCCC: TCGGACGCCCG
TCGGACGCCCG: CGGACGCCCGC
CGGACGCCCGC: GGACGCCCGCC
GGACGCCCGCC: GACGCCCGCCG
GACGCCCGCCG: ACGCCCGCCGG
ACGCCCGCCGG: CGCCCGCCGGG
CGCCCGCCGGG: GCCCGCCGGGA
GCCCGCCGGGA: CCCGCCGGGAT
CCCGCCGGGAT: CCGCCGGGATG
CCGCCGGGATG: CGCCGGGATGA
CGCCGGGATGA: GCCGGGATGAG
GCCGGGATGAG: CCGGGATGAGT
CCGGGATGAGT: CGGGATGAGTA
CGGGATGAGTA: GGGATGAGTAT
GGGATGAGTAT: GGATGAGTATT
GGATGAGTATT: GATGAGTATTG
GATGAGTATTG: ATGAGTATTGC
ATGAGTATTGC: TGAGTATTGCC
TGAGTATTGCC: GAGTATTGCCC
GAGTATTGCCC: AGTATTGCCCC
AGTATTGCCCC: GTATTGCCCCT
GTATTGCCCCT: TATTGCCCCTC
TATTGCCCCTC: ATTGCCCCTCA
ATTGCCCCTCA: TTGCCCCTCAG
TTGCCCCTCAG: TGCCCCTCAGT
TGCCCCTCAGT: GCCCCTCAGTG
GCCCCTCAGTG: CCCCTCAGTGA
CCCCTCAGTGA: CCCTCAGTGAA
CCCTCAGTGAA: CCTCAGTGAAA
CCTCAGTGAAA: CTCAGTGAAAA
CTCAGTGAAAA: TCAGTGAAAAC
TCAGTGAAAAC: CAGTGAAAACG
CAGTGAAAACG: AGTGAAAACGT
AGTGAAAACGT: GTGAAAACGTG
GTGAAAACGTG: TGAAAACGTGC
TGAAAACGTGC: GAAAACGTGCG
GAAAACGTGCG: AAAACGTGCGA
AAAACGTGCGA: AAACGTGCGAT
AAACGTGCGAT: AACGTGCGATT
AACGTGCGATT: ACGTGCGATTG
ACGTGCGATTG: CGTGCGATTGA
CGTGCGATTGA: GTGCGATTGAG
GTGCGATTGAG: TGCGATTGAGT
TGCGATTGAGT: GCGATTGAGTG
GCGATTGAGTG: CGATTGAGTGA
CGATTGAGTGA: GATTGAGTGAC
GATTGAGTGAC: ATTGAGTGACG
ATTGAGTGACG: TTGAGTGACGG
TTGAGTGACGG: TGAGTGACGGA
TGAGTGACGGA: GAGTGACGGAA
GAGTGACGGAA: AGTGACGGAAG
AGTGACGGAAG: GTGACGGAAGG
GTGACGGAAGG: TGACGGAAGGC
TGACGGAAGGC: GACGGAAGGCA
GACGGAAGGCA: ACGGAAGGCAA
ACGGAAGGCAA: CGGAAGGCAAA
CGGAAGGCAAA: GGAAGGCAAAG
GGAAGGCAAAG: GAAGGCAAAGC
GAAGGCAAAGC: AAGGCAAAGCT
AAGGCAAAGCT: AGGCAAAGCTA
AGGCAAAGCTA: GGCAAAGCTAG
GGCAAAGCTAG: GCAAAGCTAGT
GCAAAGCTAGT: CAAAGCTAGTG
CAAAGCTAGTG: AAAGCTAGTGC
AAAGCTAGTGC: AAGCTAGTGCT
AAGCTAGTGCT: AGCTAGTGCTG
AGCTAGTGCTG: GCTAGTGCTGC
GCTAGTGCTGC: CTAGTGCTGCC
CTAGTGCTGCC: TAGTGCTGCCA
TAGTGCTGCCA: AGTGCTGCCAG
AGTGCTGCCAG: GTGCTGCCAGG
GTGCTGCCAGG: TGCTGCCAGGA
TGCTGCCAGGA: GCTGCCAGGAC
GCTGCCAGGAC: CTGCCAGGACG
CTGCCAGGACG: TGCCAGGACGC
TGCCAGGACGC: GCCAGGACGCG
GCCAGGACGCG: CCAGGACGCGA
CCAGGACGCGA: CAGGACGCGAA
CAGGACGCGAA: AGGACGCGAAT
AGGACGCGAAT: GGACGCGAATA
GGACGCGAATA: GACGCGAATAC
GACGCGAATAC: ACGCGAATACT
ACGCGAATACT: CGCGAATACTT
CGCGAATACTT: GCGAATACTTT
GCGAATACTTT: CGAATACTTTG
CGAATACTTTG: GAATACTTTGA
GAATACTTTGA: AATACTTTGAA
AATACTTTGAA: ATACTTTGAAG
ATACTTTGAAG: TACTTTGAAGT
TACTTTGAAGT: ACTTTGAAGTT
ACTTTGAAGTT: CTTTGAAGTTC
CTTTGAAGTTC: TTTGAAGTTCC
TTTGAAGTTCC: TTGAAGTTCCC
TTGAAGTTCCC: TGAAGTTCCCG
TGAAGTTCCCG: GAAGTTCCCGT
GAAGTTCCCGT: AAGTTCCCGTA
AAGTTCCCGTA: AGTTCCCGTAG
AGTTCCCGTAG: GTTCCCGTAGT
GTTCCCGTAGT: TTCCCGTAGTC
TTCCCGTAGTC: TCCCGTAGTCG
TCCCGTAGTCG: CCCGTAGTCGC
CCCGTAGTCGC: CCGTAGTCGCT
CCGTAGTCGCT: CGTAGTCGCTG
CGTAGTCGCTG: GTAGTCGCTGC
GTAGTCGCTGC: TAGTCGCTGCT
TAGTCGCTGCT: AGTCGCTGCTA
AGTCGCTGCTA: GTCGCTGCTAA
GTCGCTGCTAA: TCGCTGCTAAA
TCGCTGCTAAA: CGCTGCTAAAC
CGCTGCTAAAC: GCTGCTAAACT
GCTGCTAAACT: CTGCTAAACTA
CTGCTAAACTA: TGCTAAACTAC
TGCTAAACTAC: GCTAAACTACT
GCTAAACTACT: CTAAACTACTG
CTAAACTACTG: TAAACTACTGT
TAAACTACTGT: AAACTACTGTC
AAACTACTGTC: AACTACTGTCT
AACTACTGTCT: ACTACTGTCTG
ACTACTGTCTG: CTACTGTCTGA
CTACTGTCTGA: TACTGTCTGAA
TACTGTCTGAA: ACTGTCTGAAC
ACTGTCTGAAC: CTGTCTGAACC
CTGTCTGAACC: TGTCTGAACCC
TGTCTGAACCC: GTCTGAACCCT
GTCTGAACCCT: TCTGAACCCTA
TCTGAACCCTA: CTGAACCCTAC
CTGAACCCTAC: TGAACCCTACA
TGAACCCTACA: GAACCCTACAG
GAACCCTACAG: AACCCTACAGT
AACCCTACAGT: ACCCTACAGTC
ACCCTACAGTC: CCCTACAGTCA
CCCTACAGTCA: CCTACAGTCAC
CCTACAGTCAC: CTACAGTCACT
CTACAGTCACT: TACAGTCACTC
TACAGTCACTC: ACAGTCACTCG
ACAGTCACTCG: CAGTCACTCGA
CAGTCACTCGA: AGTCACTCGAA
AGTCACTCGAA: GTCACTCGAAA
GTCACTCGAAA: TCACTCGAAAT
TCACTCGAAAT: CACTCGAAATT
CACTCGAAATT: ACTCGAAATTG
ACTCGAAATTG: CTCGAAATTGG
CTCGAAATTGG: TCGAAATTGGA
TCGAAATTGGA: CGAAATTGGAC
CGAAATTGGAC: GAAATTGGACA
GAAATTGGACA: AAATTGGACAG
AAATTGGACAG: AATTGGACAGC
AATTGGACAGC: ATTGGACAGCC
ATTGGACAGCC: TTGGACAGCCC
TTGGACAGCCC: TGGACAGCCCG
TGGACAGCCCG: GGACAGCCCGA
GGACAGCCCGA: GACAGCCCGAG
GACAGCCCGAG: ACAGCCCGAGA
ACAGCCCGAGA: CAGCCCGAGAG
CAGCCCGAGAG: AGCCCGAGAGG
AGCCCGAGAGG: GCCCGAGAGGG
GCCCGAGAGGG: CCCGAGAGGGT
CCCGAGAGGGT: CCGAGAGGGTC
CCGAGAGGGTC: CGAGAGGGTCG
CGAGAGGGTCG: GAGAGGGTCGG
GAGAGGGTCGG: AGAGGGTCGGC
AGAGGGTCGGC: GAGGGTCGGCC
GAGGGTCGGCC: AGGGTCGGCCA
AGGGTCGGCCA: GGGTCGGCCAT
GGGTCGGCCAT: GGTCGGCCATA
GGTCGGCCATA: GTCGGCCATAC
GTCGGCCATAC: TCGGCCATACG
TCGGCCATACG: CGGCCATACGA
CGGCCATACGA: GGCCATACGAT
GGCCATACGAT: GCCATACGATC
GCCATACGATC: CCATACGATCC
CCATACGATCC: CATACGATCCC
CATACGATCCC: ATACGATCCCT
ATACGATCCCT: TACGATCCCTT
TACGATCCCTT: ACGATCCCTTA
ACGATCCCTTA: CGATCCCTTAA
CGATCCCTTAA: GATCCCTTAAA
GATCCCTTAAA: ATCCCTTAAAT
ATCCCTTAAAT: TCCCTTAAATT
TCCCTTAAATT: CCCTTAAATTT
CCCTTAAATTT: CCTTAAATTTC
CCTTAAATTTC: CTTAAATTTCA
CTTAAATTTCA: TTAAATTTCAC
TTAAATTTCAC: TAAATTTCACC
TAAATTTCACC: AAATTTCACCC
AAATTTCACCC: AATTTCACCCC
AATTTCACCCC: ATTTCACCCCA
ATTTCACCCCA: TTTCACCCCAC
TTTCACCCCAC: TTCACCCCACG
TTCACCCCACG: TCACCCCACGC
TCACCCCACGC: CACCCCACGCT
CACCCCACGCT: ACCCCACGCTG
ACCCCACGCTG: CCCCACGCTGT
CCCCACGCTGT: CCCACGCTGTA
CCCACGCTGTA: CCACGCTGTAA
CCACGCTGTAA: CACGCTGTAAA
CACGCTGTAAA: ACGCTGTAAAC
ACGCTGTAAAC: CGCTGTAAACC
CGCTGTAAACC: GCTGTAAACCC
GCTGTAAACCC: CTGTAAACCCA
CTGTAAACCCA: TGTAAACCCAG
TGTAAACCCAG: GTAAACCCAGA
GTAAACCCAGA: TAAACCCAGAG
TAAACCCAGAG: AAACCCAGAGT
AAACCCAGAGT: AACCCAGAGTG
AACCCAGAGTG: ACCCAGAGTGA
ACCCAGAGTGA: CCCAGAGTGAT
CCCAGAGTGAT: CCAGAGTGATA
CCAGAGTGATA: CAGAGTGATAG
CAGAGTGATAG: AGAGTGATAGG
AGAGTGATAGG: GAGTGATAGGC
GAGTGATAGGC: AGTGATAGGCT
AGTGATAGGCT: GTGATAGGCTC
GTGATAGGCTC: TGATAGGCTCC
TGATAGGCTCC: GATAGGCTCCA
GATAGGCTCCA: ATAGGCTCCAC
ATAGGCTCCAC: TAGGCTCCACA
TAGGCTCCACA: AGGCTCCACAA
AGGCTCCACAA: GGCTCCACAAG
GGCTCCACAAG: GCTCCACAAGC
GCTCCACAAGC: CTCCACAAGCC
CTCCACAAGCC: TCCACAAGCCC
TCCACAAGCCC: CCACAAGCCCA
CCACAAGCCCA: CACAAGCCCAT
CACAAGCCCAT: ACAAGCCCATC
ACAAGCCCATC: CAAGCCCATCG
CAAGCCCATCG: AAGCCCATCGG
AAGCCCATCGG: AGCCCATCGGG
AGCCCATCGGG: GCCCATCGGGG
GCCCATCGGGG: CCCATCGGGGA
CCCATCGGGGA: CCATCGGGGAT
CCATCGGGGAT: CATCGGGGATA
CATCGGGGATA: ATCGGGGATAG
ATCGGGGATAG: TCGGGGATAGT
TCGGGGATAGT: CGGGGATAGTT
CGGGGATAGTT: GGGGATAGTTC
GGGGATAGTTC: GGGATAGTTCT
GGGATAGTTCT: GGATAGTTCTG
GGATAGTTCTG: GATAGTTCTGG
GATAGTTCTGG: ATAGTTCTGGT
ATAGTTCTGGT: TAGTTCTGGTC
TAGTTCTGGTC: AGTTCTGGTCT
AGTTCTGGTCT: GTTCTGGTCTG
GTTCTGGTCTG: TTCTGGTCTGA
TTCTGGTCTGA: TCTGGTCTGAG
TCTGGTCTGAG: CTGGTCTGAGG
CTGGTCTGAGG: TGGTCTGAGGC
TGGTCTGAGGC: GGTCTGAGGCG
GGTCTGAGGCG: GTCTGAGGCGT
GTCTGAGGCGT: TCTGAGGCGTC
TCTGAGGCGTC: CTGAGGCGTCT
CTGAGGCGTCT: TGAGGCGTCTG
TGAGGCGTCTG: GAGGCGTCTGC
GAGGCGTCTGC: AGGCGTCTGCG
AGGCGTCTGCG: GGCGTCTGCGC
GGCGTCTGCGC: GCGTCTGCGCC
GCGTCTGCGCC: CGTCTGCGCCT
CGTCTGCGCCT: GTCTGCGCCTA
GTCTGCGCCTA: TCTGCGCCTAT
TCTGCGCCTAT: CTGCGCCTATA
CTGCGCCTATA: TGCGCCTATAT
TGCGCCTATAT: GCGCCTATATG
GCGCCTATATG: CGCCTATATGG
CGCCTATATGG: GCCTATATGGG
GCCTATATGGG: CCTATATGGGG
CCTATATGGGG: CTATATGGGGG
CTATATGGGGG: TATATGGGGGC
TATATGGGGGC: ATATGGGGGCA
ATATGGGGGCA: TATGGGGGCAC
TATGGGGGCAC: ATGGGGGCACA
ATGGGGGCACA: TGGGGGCACAC
TGGGGGCACAC: GGGGGCACACA
GGGGGCACACA: GGGGCACACAT
GGGGCACACAT: GGGCACACATA
GGGCACACATA: GGCACACATAT
GGCACACATAT: GCACACATATA
GCACACATATA: CACACATATAA
CACACATATAA: ACACATATAAA
ACACATATAAA: CACATATAAAA
CACATATAAAA: ACATATAAAAA
ACATATAAAAA: CATATAAAAAT
CATATAAAAAT: ATATAAAAATG
ATATAAAAATG: TATAAAAATGG
TATAAAAATGG: ATAAAAATGGC
ATAAAAATGGC: TAAAAATGGCG
TAAAAATGGCG: AAAAATGGCGT
AAAAATGGCGT: AAAATGGCGTC
AAAATGGCGTC: AAATGGCGTCG
AAATGGCGTCG: AATGGCGTCGC
AATGGCGTCGC: ATGGCGTCGCT
ATGGCGTCGCT: TGGCGTCGCTT
TGGCGTCGCTT: GGCGTCGCTTC
GGCGTCGCTTC: GCGTCGCTTCA
GCGTCGCTTCA: CGTCGCTTCAT
CGTCGCTTCAT: GTCGCTTCATG
GTCGCTTCATG: TCGCTTCATGT
TCGCTTCATGT: CGCTTCATGTA
CGCTTCATGTA: GCTTCATGTAT
GCTTCATGTAT: CTTCATGTATG
CTTCATGTATG: TTCATGTATGT
TTCATGTATGT: TCATGTATGTA
TCATGTATGTA: CATGTATGTAA
CATGTATGTAA: ATGTATGTAAA
ATGTATGTAAA: TGTATGTAAAA
TGTATGTAAAA: GTATGTAAAAA
GTATGTAAAAA: TATGTAAAAAG
TATGTAAAAAG: ATGTAAAAAGT
ATGTAAAAAGT: TGTAAAAAGTA
TGTAAAAAGTA: GTAAAAAGTAT
GTAAAAAGTAT: TAAAAAGTATG
TAAAAAGTATG: AAAAAGTATGA
AAAAAGTATGA: AAAAGTATGAA
AAAAGTATGAA: AAAGTATGAAA
AAAGTATGAAA: AAGTATGAAAT
AAGTATGAAAT: AGTATGAAATA
AGTATGAAATA: GTATGAAATAC
GTATGAAATAC: TATGAAATACG
TATGAAATACG: ATGAAATACGC
ATGAAATACGC: TGAAATACGCC
TGAAATACGCC: GAAATACGCCC
GAAATACGCCC: AAATACGCCCG
AAATACGCCCG: AATACGCCCGG
AATACGCCCGG: ATACGCCCGGG
ATACGCCCGGG: TACGCCCGGGT
TACGCCCGGGT: ACGCCCGGGTT
ACGCCCGGGTT: CGCCCGGGTTC
CGCCCGGGTTC: GCCCGGGTTCG
GCCCGGGTTCG: CCCGGGTTCGC
CCCGGGTTCGC: CCGGGTTCGCC
CCGGGTTCGCC: CGGGTTCGCCC
CGGGTTCGCCC: GGGTTCGCCCA
GGGTTCGCCCA: GGTTCGCCCAG
GGTTCGCCCAG: GTTCGCCCAGT
GTTCGCCCAGT: TTCGCCCAGTG
TTCGCCCAGTG: TCGCCCAGTGG
TCGCCCAGTGG: CGCCCAGTGGG
CGCCCAGTGGG: GCCCAGTGGGG
GCCCAGTGGGG: CCCAGTGGGGC
CCCAGTGGGGC: CCAGTGGGGCT
CCAGTGGGGCT: CAGTGGGGCTG
CAGTGGGGCTG: AGTGGGGCTGC
AGTGGGGCTGC: GTGGGGCTGCG
GTGGGGCTGCG: TGGGGCTGCGA
TGGGGCTGCGA: GGGGCTGCGAA
GGGGCTGCGAA: GGGCTGCGAAG
GGGCTGCGAAG: GGCTGCGAAGG
GGCTGCGAAGG: GCTGCGAAGGA
GCTGCGAAGGA: CTGCGAAGGAG
CTGCGAAGGAG: TGCGAAGGAGG
TGCGAAGGAGG: GCGAAGGAGGA
GCGAAGGAGGA: CGAAGGAGGAC
CGAAGGAGGAC: GAAGGAGGACT
GAAGGAGGACT: AAGGAGGACTA
AAGGAGGACTA: AGGAGGACTAA
AGGAGGACTAA: GGAGGACTAAG
GGAGGACTAAG: GAGGACTAAGA
GAGGACTAAGA: AGGACTAAGAA
AGGACTAAGAA: GGACTAAGAAT
GGACTAAGAAT: GACTAAGAATC
GACTAAGAATC: ACTAAGAATCC
ACTAAGAATCC: CTAAGAATCCT
CTAAGAATCCT: TAAGAATCCTT
TAAGAATCCTT: AAGAATCCTTA
AAGAATCCTTA: AGAATCCTTAC
AGAATCCTTAC: GAATCCTTACA
GAATCCTTACA: AATCCTTACAG
AATCCTTACAG: ATCCTTACAGG
ATCCTTACAGG: TCCTTACAGGT
TCCTTACAGGT: CCTTACAGGTA
CCTTACAGGTA: CTTACAGGTAG
CTTACAGGTAG: TTACAGGTAGT
TTACAGGTAGT: TACAGGTAGTT
TACAGGTAGTT: ACAGGTAGTTG
ACAGGTAGTTG: CAGGTAGTTGC
CAGGTAGTTGC: AGGTAGTTGCG
AGGTAGTTGCG: GGTAGTTGCGT
GGTAGTTGCGT: GTAGTTGCGTA
GTAGTTGCGTA: TAGTTGCGTAA
TAGTTGCGTAA: AGTTGCGTAAG
AGTTGCGTAAG: GTTGCGTAAGC
GTTGCGTAAGC: TTGCGTAAGCC
TTGCGTAAGCC: TGCGTAAGCCA
TGCGTAAGCCA: GCGTAAGCCAA
GCGTAAGCCAA: CGTAAGCCAAC
CGTAAGCCAAC: GTAAGCCAACC
GTAAGCCAACC: TAAGCCAACCC
TAAGCCAACCC: AAGCCAACCCC
AAGCCAACCCC: AGCCAACCCCT
AGCCAACCCCT: GCCAACCCCTA
GCCAACCCCTA: CCAACCCCTAG
CCAACCCCTAG: CAACCCCTAGC
CAACCCCTAGC: AACCCCTAGCC
AACCCCTAGCC: ACCCCTAGCCT
ACCCCTAGCCT: CCCCTAGCCTT
CCCCTAGCCTT: CCCTAGCCTTC
CCCTAGCCTTC: CCTAGCCTTCC
CCTAGCCTTCC: CTAGCCTTCCG
CTAGCCTTCCG: TAGCCTTCCGG
TAGCCTTCCGG: AGCCTTCCGGC
AGCCTTCCGGC: GCCTTCCGGCA
GCCTTCCGGCA: CCTTCCGGCAC
CCTTCCGGCAC: CTTCCGGCACC
CTTCCGGCACC: TTCCGGCACCA
TTCCGGCACCA: TCCGGCACCAG
TCCGGCACCAG: CCGGCACCAGT
CCGGCACCAGT: CGGCACCAGTC
CGGCACCAGTC: GGCACCAGTCA
GGCACCAGTCA: GCACCAGTCAC
GCACCAGTCAC: CACCAGTCACC
CACCAGTCACC: ACCAGTCACCG
ACCAGTCACCG: CCAGTCACCGA
CCAGTCACCGA: CAGTCACCGAT
CAGTCACCGAT: AGTCACCGATT
AGTCACCGATT: GTCACCGATTA
GTCACCGATTA: TCACCGATTAG
TCACCGATTAG: CACCGATTAGA
CACCGATTAGA: ACCGATTAGAA
ACCGATTAGAA: CCGATTAGAAC
CCGATTAGAAC: CGATTAGAACA
CGATTAGAACA: GATTAGAACAA
GATTAGAACAA: ATTAGAACAAC
ATTAGAACAAC: TTAGAACAACA
TTAGAACAACA: TAGAACAACAT
TAGAACAACAT: AGAACAACATA
AGAACAACATA: GAACAACATAC
GAACAACATAC: AACAACATACC
AACAACATACC: ACAACATACCA
ACAACATACCA: CAACATACCAT
CAACATACCAT: AACATACCATG
AACATACCATG: ACATACCATGA
ACATACCATGA: CATACCATGAC
CATACCATGAC: ATACCATGACC
ATACCATGACC: TACCATGACCC
TACCATGACCC: ACCATGACCCG
ACCATGACCCG: CCATGACCCGT
CCATGACCCGT: CATGACCCGTG
CATGACCCGTG: ATGACCCGTGG
ATGACCCGTGG: TGACCCGTGGG
TGACCCGTGGG: GACCCGTGGGC
GACCCGTGGGC: ACCCGTGGGCC
ACCCGTGGGCC: CCCGTGGGCCC
CCCGTGGGCCC: CCGTGGGCCCC
CCGTGGGCCCC: CGTGGGCCCCC
CGTGGGCCCCC: GTGGGCCCCCC
GTGGGCCCCCC: TGGGCCCCCCA
TGGGCCCCCCA: GGGCCCCCCAG
GGGCCCCCCAG: GGCCCCCCAGA
GGCCCCCCAGA: GCCCCCCAGAG
GCCCCCCAGAG: CCCCCCAGAGT
CCCCCCAGAGT: CCCCCAGAGTC
CCCCCAGAGTC: CCCCAGAGTCC
CCCCAGAGTCC: CCCAGAGTCCG
CCCAGAGTCCG: CCAGAGTCCGA
CCAGAGTCCGA: CAGAGTCCGAT
CAGAGTCCGAT: AGAGTCCGATG
AGAGTCCGATG: GAGTCCGATGG
GAGTCCGATGG: AGTCCGATGGA
AGTCCGATGGA: GTCCGATGGAA
GTCCGATGGAA: TCCGATGGAAC
TCCGATGGAAC: CCGATGGAACC
CCGATGGAACC: CGATGGAACCC
CGATGGAACCC: GATGGAACCCG
GATGGAACCCG: ATGGAACCCGA
ATGGAACCCGA: TGGAACCCGAG
TGGAACCCGAG: GGAACCCGAGC
GGAACCCGAGC: GAACCCGAGCA
GAACCCGAGCA: AACCCGAGCAT
AACCCGAGCAT: ACCCGAGCATG
ACCCGAGCATG: CCCGAGCATGA
CCCGAGCATGA: CCGAGCATGAC
CCGAGCATGAC: CGAGCATGACA
CGAGCATGACA: GAGCATGACAC
GAGCATGACAC: AGCATGACACT
AGCATGACACT: GCATGACACTC
GCATGACACTC: CATGACACTCC
CATGACACTCC: ATGACACTCCA
ATGACACTCCA: TGACACTCCAA
TGACACTCCAA: GACACTCCAAG
GACACTCCAAG: ACACTCCAAGC
ACACTCCAAGC: CACTCCAAGCA
CACTCCAAGCA: ACTCCAAGCAA
ACTCCAAGCAA: CTCCAAGCAAC
CTCCAAGCAAC: TCCAAGCAACC
TCCAAGCAACC: CCAAGCAACCT
CCAAGCAACCT: CAAGCAACCTC
CAAGCAACCTC: AAGCAACCTCT
AAGCAACCTCT: AGCAACCTCTG
AGCAACCTCTG: GCAACCTCTGA
GCAACCTCTGA: CAACCTCTGAG
CAACCTCTGAG: AACCTCTGAGT
AACCTCTGAGT: ACCTCTGAGTA
ACCTCTGAGTA: CCTCTGAGTAG
CCTCTGAGTAG: CTCTGAGTAGG
CTCTGAGTAGG: TCTGAGTAGGT
TCTGAGTAGGT: CTGAGTAGGTT
CTGAGTAGGTT: TGAGTAGGTTA
TGAGTAGGTTA: GAGTAGGTTAG
GAGTAGGTTAG: AGTAGGTTAGA
AGTAGGTTAGA: GTAGGTTAGAT
GTAGGTTAGAT: TAGGTTAGATG
TAGGTTAGATG: AGGTTAGATGA
AGGTTAGATGA: GGTTAGATGAG
GGTTAGATGAG: GTTAGATGAGG
GTTAGATGAGG: TTAGATGAGGT
TTAGATGAGGT: TAGATGAGGTA
TAGATGAGGTA: AGATGAGGTAA
AGATGAGGTAA: GATGAGGTAAA
GATGAGGTAAA: ATGAGGTAAAC
ATGAGGTAAAC: TGAGGTAAACG
TGAGGTAAACG: GAGGTAAACGG
GAGGTAAACGG: AGGTAAACGGA
AGGTAAACGGA: GGTAAACGGAT
GGTAAACGGAT: GTAAACGGATT
GTAAACGGATT: TAAACGGATTG
TAAACGGATTG: AAACGGATTGA
AAACGGATTGA: AACGGATTGAG
AACGGATTGAG: ACGGATTGAGC
ACGGATTGAGC: CGGATTGAGCG
CGGATTGAGCG: GGATTGAGCGC
GGATTGAGCGC: GATTGAGCGCT
GATTGAGCGCT: ATTGAGCGCTT
ATTGAGCGCTT: TTGAGCGCTTG
TTGAGCGCTTG: TGAGCGCTTGT
TGAGCGCTTGT: GAGCGCTTGTG
GAGCGCTTGTG: AGCGCTTGTGA
AGCGCTTGTGA: GCGCTTGTGAG
GCGCTTGTGAG: CGCTTGTGAGG
CGCTTGTGAGG: GCTTGTGAGGC
GCTTGTGAGGC: CTTGTGAGGCC
CTTGTGAGGCC: TTGTGAGGCCT
TTGTGAGGCCT: TGTGAGGCCTT
TGTGAGGCCTT: GTGAGGCCTTG
GTGAGGCCTTG: TGAGGCCTTGC
TGAGGCCTTGC: GAGGCCTTGCT
GAGGCCTTGCT: AGGCCTTGCTT
AGGCCTTGCTT: GGCCTTGCTTC
GGCCTTGCTTC: GCCTTGCTTCG
GCCTTGCTTCG: CCTTGCTTCGG
CCTTGCTTCGG: CTTGCTTCGGG
CTTGCTTCGGG: TTGCTTCGGGG
TTGCTTCGGGG: TGCTTCGGGGC
TGCTTCGGGGC: GCTTCGGGGCT
GCTTCGGGGCT: CTTCGGGGCTG
CTTCGGGGCTG: TTCGGGGCTGC
TTCGGGGCTGC: TCGGGGCTGCC
TCGGGGCTGCC: CGGGGCTGCCC
CGGGGCTGCCC: GGGGCTGCCCG
GGGGCTGCCCG: GGGCTGCCCGG
GGGCTGCCCGG: GGCTGCCCGGG
GGCTGCCCGGG: GCTGCCCGGGA
GCTGCCCGGGA: CTGCCCGGGAG
CTGCCCGGGAG: TGCCCGGGAGG
TGCCCGGGAGG: GCCCGGGAGGG
GCCCGGGAGGG: CCCGGGAGGGT
CCCGGGAGGGT: CCGGGAGGGTG
CCGGGAGGGTG: CGGGAGGGTGA
CGGGAGGGTGA: GGGAGGGTGAA
GGGAGGGTGAA: GGAGGGTGAAA
GGAGGGTGAAA: GAGGGTGAAAT
GAGGGTGAAAT: AGGGTGAAATA
AGGGTGAAATA: GGGTGAAATAT
GGGTGAAATAT: GGTGAAATATG
GGTGAAATATG: GTGAAATATGC
GTGAAATATGC: TGAAATATGCA
TGAAATATGCA: GAAATATGCAC
GAAATATGCAC: AAATATGCACC
AAATATGCACC: AATATGCACCT
AATATGCACCT: ATATGCACCTT
ATATGCACCTT: TATGCACCTTG
TATGCACCTTG: ATGCACCTTGT
ATGCACCTTGT: TGCACCTTGTT
TGCACCTTGTT: GCACCTTGTTT
GCACCTTGTTT: CACCTTGTTTA
CACCTTGTTTA: ACCTTGTTTAG
ACCTTGTTTAG: CCTTGTTTAGG
CCTTGTTTAGG: CTTGTTTAGGC
CTTGTTTAGGC: TTGTTTAGGCA
TTGTTTAGGCA: TGTTTAGGCAT
TGTTTAGGCAT: GTTTAGGCATC
GTTTAGGCATC: TTTAGGCATCG
TTTAGGCATCG: TTAGGCATCGT
TTAGGCATCGT: TAGGCATCGTT
TAGGCATCGTT: AGGCATCGTTG
AGGCATCGTTG: GGCATCGTTGG
GGCATCGTTGG: GCATCGTTGGG
GCATCGTTGGG: CATCGTTGGGC
CATCGTTGGGC: ATCGTTGGGCG
ATCGTTGGGCG: TCGTTGGGCGT
TCGTTGGGCGT: CGTTGGGCGTG
CGTTGGGCGTG: GTTGGGCGTGT
GTTGGGCGTGT: TTGGGCGTGTA
TTGGGCGTGTA: TGGGCGTGTAT
TGGGCGTGTAT: GGGCGTGTATA
GGGCGTGTATA: GGCGTGTATAA
GGCGTGTATAA: GCGTGTATAAG
GCGTGTATAAG: CGTGTATAAGA
CGTGTATAAGA: GTGTATAAGAT
GTGTATAAGAT: TGTATAAGATA
TGTATAAGATA: GTATAAGATAT
GTATAAGATAT: TATAAGATATC
TATAAGATATC: ATAAGATATCC
ATAAGATATCC: TAAGATATCCG
TAAGATATCCG: AAGATATCCGA
AAGATATCCGA: AGATATCCGAA
AGATATCCGAA: GATATCCGAAT
GATATCCGAAT: ATATCCGAATA
ATATCCGAATA: TATCCGAATAG
TATCCGAATAG: ATCCGAATAGT
ATCCGAATAGT: TCCGAATAGTC
TCCGAATAGTC: CCGAATAGTCT
CCGAATAGTCT: CGAATAGTCTC
CGAATAGTCTC: GAATAGTCTCC
GAATAGTCTCC: AATAGTCTCCT
AATAGTCTCCT: ATAGTCTCCTA
ATAGTCTCCTA: TAGTCTCCTAA
TAGTCTCCTAA: AGTCTCCTAAC
AGTCTCCTAAC: GTCTCCTAACG
GTCTCCTAACG: TCTCCTAACGT
TCTCCTAACGT: CTCCTAACGTT
CTCCTAACGTT: TCCTAACGTTT
TCCTAACGTTT: CCTAACGTTTT
CCTAACGTTTT: CTAACGTTTTG
CTAACGTTTTG: TAACGTTTTGT
TAACGTTTTGT: AACGTTTTGTT
AACGTTTTGTT: ACGTTTTGTTC
ACGTTTTGTTC: CGTTTTGTTCA
CGTTTTGTTCA: GTTTTGTTCAT
GTTTTGTTCAT: TTTTGTTCATC
TTTTGTTCATC: TTTGTTCATCC
TTTGTTCATCC: TTGTTCATCCT
TTGTTCATCCT: TGTTCATCCTC
TGTTCATCCTC: GTTCATCCTCT
GTTCATCCTCT: TTCATCCTCTA
TTCATCCTCTA: TCATCCTCTAA
TCATCCTCTAA: CATCCTCTAAA
CATCCTCTAAA: ATCCTCTAAAG
ATCCTCTAAAG: TCCTCTAAAGC
TCCTCTAAAGC: CCTCTAAAGCC
CCTCTAAAGCC: CTCTAAAGCCT
CTCTAAAGCCT: TCTAAAGCCTC
TCTAAAGCCTC: CTAAAGCCTCC
CTAAAGCCTCC: TAAAGCCTCCT
TAAAGCCTCCT: AAAGCCTCCTA
AAAGCCTCCTA: AAGCCTCCTAC
AAGCCTCCTAC: AGCCTCCTACT
AGCCTCCTACT: GCCTCCTACTA
GCCTCCTACTA: CCTCCTACTAA
CCTCCTACTAA: CTCCTACTAAT
CTCCTACTAAT: TCCTACTAATA
TCCTACTAATA: CCTACTAATAG
CCTACTAATAG: CTACTAATAGT
CTACTAATAGT: TACTAATAGTC
TACTAATAGTC: ACTAATAGTCA
ACTAATAGTCA: CTAATAGTCAG
CTAATAGTCAG: TAATAGTCAGT
TAATAGTCAGT: AATAGTCAGTG
AATAGTCAGTG: ATAGTCAGTGG
ATAGTCAGTGG: TAGTCAGTGGA
TAGTCAGTGGA: AGTCAGTGGAG
AGTCAGTGGAG: GTCAGTGGAGA
GTCAGTGGAGA: TCAGTGGAGAA
TCAGTGGAGAA: CAGTGGAGAAC
CAGTGGAGAAC: AGTGGAGAACG
AGTGGAGAACG: GTGGAGAACGT
GTGGAGAACGT: TGGAGAACGTT
TGGAGAACGTT: GGAGAACGTTC
GGAGAACGTTC: GAGAACGTTCT
GAGAACGTTCT: AGAACGTTCTC
AGAACGTTCTC: GAACGTTCTCT
GAACGTTCTCT: AACGTTCTCTG
AACGTTCTCTG: ACGTTCTCTGG
ACGTTCTCTGG: CGTTCTCTGGG
CGTTCTCTGGG: GTTCTCTGGGA
GTTCTCTGGGA: TTCTCTGGGAG
TTCTCTGGGAG: TCTCTGGGAGA
TCTCTGGGAGA: CTCTGGGAGAG
CTCTGGGAGAG: TCTGGGAGAGG
TCTGGGAGAGG: CTGGGAGAGGG
CTGGGAGAGGG: TGGGAGAGGGA
TGGGAGAGGGA: GGGAGAGGGAT
GGGAGAGGGAT: GGAGAGGGATC
GGAGAGGGATC: GAGAGGGATCC
GAGAGGGATCC: AGAGGGATCCA
AGAGGGATCCA: GAGGGATCCAT
GAGGGATCCAT: AGGGATCCATT
AGGGATCCATT: GGGATCCATTT
GGGATCCATTT: GGATCCATTTC
GGATCCATTTC: GATCCATTTCA
GATCCATTTCA: ATCCATTTCAA
ATCCATTTCAA: TCCATTTCAAT
TCCATTTCAAT: CCATTTCAATA
CCATTTCAATA: CATTTCAATAT
CATTTCAATAT: ATTTCAATATC
ATTTCAATATC: TTTCAATATCC
TTTCAATATCC: TTCAATATCCA
TTCAATATCCA: TCAATATCCAC
TCAATATCCAC: CAATATCCACA
CAATATCCACA: AATATCCACAC
AATATCCACAC: ATATCCACACT
ATATCCACACT: TATCCACACTG
TATCCACACTG: ATCCACACTGT
ATCCACACTGT: TCCACACTGTA
TCCACACTGTA: CCACACTGTAA
CCACACTGTAA: CACACTGTAAC
CACACTGTAAC: ACACTGTAACA
ACACTGTAACA: CACTGTAACAC
CACTGTAACAC: ACTGTAACACA
ACTGTAACACA: CTGTAACACAT
CTGTAACACAT: TGTAACACATC
TGTAACACATC: GTAACACATCA
GTAACACATCA: TAACACATCAG
TAACACATCAG: AACACATCAGA
AACACATCAGA: ACACATCAGAA
ACACATCAGAA: CACATCAGAAT
CACATCAGAAT: ACATCAGAATA
ACATCAGAATA: CATCAGAATAT
CATCAGAATAT: ATCAGAATATG
ATCAGAATATG: TCAGAATATGA
TCAGAATATGA: CAGAATATGAA
CAGAATATGAA: AGAATATGAAG
AGAATATGAAG: GAATATGAAGC
GAATATGAAGC: AATATGAAGCC
AATATGAAGCC: ATATGAAGCCA
ATATGAAGCCA: TATGAAGCCAC
TATGAAGCCAC: ATGAAGCCACG
ATGAAGCCACG: TGAAGCCACGT
TGAAGCCACGT: GAAGCCACGTA
GAAGCCACGTA: AAGCCACGTAC
AAGCCACGTAC: AGCCACGTACC
AGCCACGTACC: GCCACGTACCA
GCCACGTACCA: CCACGTACCAA
CCACGTACCAA: CACGTACCAAG
CACGTACCAAG: ACGTACCAAGT
ACGTACCAAGT: CGTACCAAGTC
CGTACCAAGTC: GTACCAAGTCA
GTACCAAGTCA: TACCAAGTCAT
TACCAAGTCAT: ACCAAGTCATA
ACCAAGTCATA: CCAAGTCATAG
CCAAGTCATAG: CAAGTCATAGA
CAAGTCATAGA: AAGTCATAGAC
AAGTCATAGAC: AGTCATAGACC
AGTCATAGACC: GTCATAGACCG
GTCATAGACCG: TCATAGACCGC
TCATAGACCGC: CATAGACCGCC
CATAGACCGCC: ATAGACCGCCC
ATAGACCGCCC: TAGACCGCCCA
TAGACCGCCCA: AGACCGCCCAA
AGACCGCCCAA: GACCGCCCAAG
GACCGCCCAAG: ACCGCCCAAGA
ACCGCCCAAGA: CCGCCCAAGAC
CCGCCCAAGAC: CGCCCAAGACG
CGCCCAAGACG: GCCCAAGACGA
GCCCAAGACGA: CCCAAGACGAG
CCCAAGACGAG: CCAAGACGAGT
CCAAGACGAGT: CAAGACGAGTC
CAAGACGAGTC: AAGACGAGTCA
AAGACGAGTCA: AGACGAGTCAC
AGACGAGTCAC: GACGAGTCACC
GACGAGTCACC: ACGAGTCACCA
ACGAGTCACCA: CGAGTCACCAC
CGAGTCACCAC: GAGTCACCACA
GAGTCACCACA: AGTCACCACAA
AGTCACCACAA: GTCACCACAAG
GTCACCACAAG: TCACCACAAGG
TCACCACAAGG: CACCACAAGGT
CACCACAAGGT: ACCACAAGGTC
ACCACAAGGTC: CCACAAGGTCT
CCACAAGGTCT: CACAAGGTCTG
CACAAGGTCTG: ACAAGGTCTGG
ACAAGGTCTGG: CAAGGTCTGGC
CAAGGTCTGGC: AAGGTCTGGCG
AAGGTCTGGCG: AGGTCTGGCGC
AGGTCTGGCGC: GGTCTGGCGCA
GGTCTGGCGCA: GTCTGGCGCAC
GTCTGGCGCAC: TCTGGCGCACG
TCTGGCGCACG: CTGGCGCACGC
CTGGCGCACGC: TGGCGCACGCA
TGGCGCACGCA: GGCGCACGCAA
GGCGCACGCAA: GCGCACGCAAG
GCGCACGCAAG: CGCACGCAAGA
CGCACGCAAGA: GCACGCAAGAG
GCACGCAAGAG: CACGCAAGAGT
CACGCAAGAGT: ACGCAAGAGTG
ACGCAAGAGTG: CGCAAGAGTGT
CGCAAGAGTGT: GCAAGAGTGTA
GCAAGAGTGTA: CAAGAGTGTAC
CAAGAGTGTAC: AAGAGTGTACA
AAGAGTGTACA: AGAGTGTACAA
AGAGTGTACAA: GAGTGTACAAA
GAGTGTACAAA: AGTGTACAAAG
AGTGTACAAAG: GTGTACAAAGG
GTGTACAAAGG: TGTACAAAGGT
TGTACAAAGGT: GTACAAAGGTC
GTACAAAGGTC: TACAAAGGTCA
TACAAAGGTCA: ACAAAGGTCAA
ACAAAGGTCAA: CAAAGGTCAAA
CAAAGGTCAAA: AAAGGTCAAAA
AAAGGTCAAAA: AAGGTCAAAAG
AAGGTCAAAAG: AGGTCAAAAGG
AGGTCAAAAGG: GGTCAAAAGGC
GGTCAAAAGGC: GTCAAAAGGCG
GTCAAAAGGCG: TCAAAAGGCGT
TCAAAAGGCGT: CAAAAGGCGTT
CAAAAGGCGTT: AAAAGGCGTTG
AAAAGGCGTTG: AAAGGCGTTGC
AAAGGCGTTGC: AAGGCGTTGCC
AAGGCGTTGCC: AGGCGTTGCCT
AGGCGTTGCCT: GGCGTTGCCTC
GGCGTTGCCTC: GCGTTGCCTCC
GCGTTGCCTCC: CGTTGCCTCCG
CGTTGCCTCCG: GTTGCCTCCGC
GTTGCCTCCGC: TTGCCTCCGCA
TTGCCTCCGCA: TGCCTCCGCAT
TGCCTCCGCAT: GCCTCCGCATA
GCCTCCGCATA: CCTCCGCATAT
CCTCCGCATAT: CTCCGCATATG
CTCCGCATATG: TCCGCATATGG
TCCGCATATGG: CCGCATATGGG
CCGCATATGGG: CGCATATGGGG
CGCATATGGGG: GCATATGGGGA
GCATATGGGGA: CATATGGGGAC
CATATGGGGAC: ATATGGGGACC
ATATGGGGACC: TATGGGGACCA
TATGGGGACCA: ATGGGGACCAT
ATGGGGACCAT: TGGGGACCATT
TGGGGACCATT: GGGGACCATTG
GGGGACCATTG: GGGACCATTGT
GGGACCATTGT: GGACCATTGTT
GGACCATTGTT: GACCATTGTTA
GACCATTGTTA: ACCATTGTTAC
ACCATTGTTAC: CCATTGTTACT
CCATTGTTACT: CATTGTTACTA
CATTGTTACTA: ATTGTTACTAA
ATTGTTACTAA: TTGTTACTAAA
TTGTTACTAAA: TGTTACTAAAT
TGTTACTAAAT: GTTACTAAATC
GTTACTAAATC: TTACTAAATCG
TTACTAAATCG: TACTAAATCGA
TACTAAATCGA: ACTAAATCGAA
ACTAAATCGAA: CTAAATCGAAC
CTAAATCGAAC: TAAATCGAACG
TAAATCGAACG: AAATCGAACGT
AAATCGAACGT: AATCGAACGTG
AATCGAACGTG: ATCGAACGTGC
ATCGAACGTGC: TCGAACGTGCG
TCGAACGTGCG: CGAACGTGCGC
CGAACGTGCGC: GAACGTGCGCG
GAACGTGCGCG: AACGTGCGCGC
AACGTGCGCGC: ACGTGCGCGCT
ACGTGCGCGCT: CGTGCGCGCTA
CGTGCGCGCTA: GTGCGCGCTAC
GTGCGCGCTAC: TGCGCGCTACT
TGCGCGCTACT: GCGCGCTACTC
GCGCGCTACTC: CGCGCTACTCA
CGCGCTACTCA: GCGCTACTCAA
GCGCTACTCAA: CGCTACTCAAC
CGCTACTCAAC: GCTACTCAACA
GCTACTCAACA: CTACTCAACAC
CTACTCAACAC: TACTCAACACT
TACTCAACACT: ACTCAACACTT
ACTCAACACTT: CTCAACACTTC
CTCAACACTTC: TCAACACTTCA
TCAACACTTCA: CAACACTTCAG
CAACACTTCAG: AACACTTCAGA
AACACTTCAGA: ACACTTCAGAC
ACACTTCAGAC: CACTTCAGACC
CACTTCAGACC: ACTTCAGACCG
ACTTCAGACCG: CTTCAGACCGC
CTTCAGACCGC: TTCAGACCGCC
TTCAGACCGCC: TCAGACCGCCG
TCAGACCGCCG: CAGACCGCCGA
CAGACCGCCGA: AGACCGCCGAA
AGACCGCCGAA: GACCGCCGAAC
GACCGCCGAAC: ACCGCCGAACG
ACCGCCGAACG: CCGCCGAACGA
CCGCCGAACGA: CGCCGAACGAG
CGCCGAACGAG: GCCGAACGAGC
GCCGAACGAGC: CCGAACGAGCC
CCGAACGAGCC: CGAACGAGCCG
CGAACGAGCCG: GAACGAGCCGA
GAACGAGCCGA: AACGAGCCGAG
AACGAGCCGAG: ACGAGCCGAGC
ACGAGCCGAGC: CGAGCCGAGCA
CGAGCCGAGCA: GAGCCGAGCAC
GAGCCGAGCAC: AGCCGAGCACA
AGCCGAGCACA: GCCGAGCACAG
GCCGAGCACAG: CCGAGCACAGC
CCGAGCACAGC: CGAGCACAGCC
CGAGCACAGCC: GAGCACAGCCT
GAGCACAGCCT: AGCACAGCCTA
AGCACAGCCTA: GCACAGCCTAT
GCACAGCCTAT: CACAGCCTATA
CACAGCCTATA: ACAGCCTATAG
ACAGCCTATAG: CAGCCTATAGC
CAGCCTATAGC: AGCCTATAGCA
AGCCTATAGCA: GCCTATAGCAC
GCCTATAGCAC: CCTATAGCACT
CCTATAGCACT: CTATAGCACTC
CTATAGCACTC: TATAGCACTCA
TATAGCACTCA: ATAGCACTCAG
ATAGCACTCAG: TAGCACTCAGT
TAGCACTCAGT: AGCACTCAGTA
AGCACTCAGTA: GCACTCAGTAG
GCACTCAGTAG: CACTCAGTAGC
CACTCAGTAGC: ACTCAGTAGCC
ACTCAGTAGCC: CTCAGTAGCCC
CTCAGTAGCCC: TCAGTAGCCCC
TCAGTAGCCCC: CAGTAGCCCCA
CAGTAGCCCCA: AGTAGCCCCAG
AGTAGCCCCAG: GTAGCCCCAGG
GTAGCCCCAGG: TAGCCCCAGGT
TAGCCCCAGGT: AGCCCCAGGTC
AGCCCCAGGTC: GCCCCAGGTCA
GCCCCAGGTCA: CCCCAGGTCAG
CCCCAGGTCAG: CCCAGGTCAGT
CCCAGGTCAGT: CCAGGTCAGTG
CCAGGTCAGTG: CAGGTCAGTGG
CAGGTCAGTGG: AGGTCAGTGGT
AGGTCAGTGGT: GGTCAGTGGTT
GGTCAGTGGTT: GTCAGTGGTTC
GTCAGTGGTTC: TCAGTGGTTCT
TCAGTGGTTCT: CAGTGGTTCTG
CAGTGGTTCTG: AGTGGTTCTGA
AGTGGTTCTGA: GTGGTTCTGAT
GTGGTTCTGAT: TGGTTCTGATA
TGGTTCTGATA: GGTTCTGATAT
GGTTCTGATAT: GTTCTGATATG
GTTCTGATATG: TTCTGATATGA
TTCTGATATGA: TCTGATATGAG
TCTGATATGAG: CTGATATGAGT
CTGATATGAGT: TGATATGAGTG
TGATATGAGTG: GATATGAGTGC
GATATGAGTGC: ATATGAGTGCC
ATATGAGTGCC: TATGAGTGCCG
TATGAGTGCCG: ATGAGTGCCGG
ATGAGTGCCGG: TGAGTGCCGGT
TGAGTGCCGGT: GAGTGCCGGTC
GAGTGCCGGTC: AGTGCCGGTCA
AGTGCCGGTCA: GTGCCGGTCAC
GTGCCGGTCAC: TGCCGGTCACG
TGCCGGTCACG: GCCGGTCACGA
GCCGGTCACGA: CCGGTCACGAC
CCGGTCACGAC: CGGTCACGACC
CGGTCACGACC: GGTCACGACCC
GGTCACGACCC: GTCACGACCCA
GTCACGACCCA: TCACGACCCAC
TCACGACCCAC: CACGACCCACC
CACGACCCACC: ACGACCCACCT
ACGACCCACCT: CGACCCACCTT
CGACCCACCTT: GACCCACCTTT
GACCCACCTTT: ACCCACCTTTC
ACCCACCTTTC: CCCACCTTTCT
CCCACCTTTCT: CCACCTTTCTT
CCACCTTTCTT: CACCTTTCTTA
CACCTTTCTTA: ACCTTTCTTAG
ACCTTTCTTAG: CCTTTCTTAGC
CCTTTCTTAGC: CTTTCTTAGCC
CTTTCTTAGCC: TTTCTTAGCCA
TTTCTTAGCCA: TTCTTAGCCAG
TTCTTAGCCAG: TCTTAGCCAGC
TCTTAGCCAGC: CTTAGCCAGCG
CTTAGCCAGCG: TTAGCCAGCGC
TTAGCCAGCGC: TAGCCAGCGCT
TAGCCAGCGCT: AGCCAGCGCTC
AGCCAGCGCTC: GCCAGCGCTCT
GCCAGCGCTCT: CCAGCGCTCTA
CCAGCGCTCTA: CAGCGCTCTAG
CAGCGCTCTAG: AGCGCTCTAGA
AGCGCTCTAGA: GCGCTCTAGAA
GCGCTCTAGAA: CGCTCTAGAAT
CGCTCTAGAAT: GCTCTAGAATG
GCTCTAGAATG: CTCTAGAATGG
CTCTAGAATGG: TCTAGAATGGA
TCTAGAATGGA: CTAGAATGGAC
CTAGAATGGAC: TAGAATGGACG
TAGAATGGACG: AGAATGGACGG
AGAATGGACGG: GAATGGACGGG
GAATGGACGGG: AATGGACGGGA
AATGGACGGGA: ATGGACGGGAC
ATGGACGGGAC: TGGACGGGACG
TGGACGGGACG: GGACGGGACGA
GGACGGGACGA: GACGGGACGAA
GACGGGACGAA: ACGGGACGAAC
ACGGGACGAAC: CGGGACGAACC
CGGGACGAACC: GGGACGAACCG
GGGACGAACCG: GGACGAACCGT
GGACGAACCGT: GACGAACCGTC
GACGAACCGTC: ACGAACCGTCT
ACGAACCGTCT: CGAACCGTCTT
CGAACCGTCTT: GAACCGTCTTT
GAACCGTCTTT: AACCGTCTTTC
AACCGTCTTTC: ACCGTCTTTCG
ACCGTCTTTCG: CCGTCTTTCGA
CCGTCTTTCGA: CGTCTTTCGAT
CGTCTTTCGAT: GTCTTTCGATG
GTCTTTCGATG: TCTTTCGATGT
